precinct,county,parish_name,rep_votes,dem_votes,total_votes,votes_needed,OBJECTID
3-7,22001,Acadia,373,77,450,54,35
4-2,22001,Acadia,287,47,334,40,15
7-3,22001,Acadia,461,34,495,59,7
35,22005,Ascension,292,81,373,45,94
5-3,22001,Acadia,172,37,209,25,20
1-5B,22001,Acadia,85,113,198,23,3
3-1,22001,Acadia,313,120,433,52,12
6-1,22007,Assumption,144,246,390,47,150
2-5,22003,Allen,2,67,69,8,64
10,22005,Ascension,464,104,568,68,102
605,22103,St. Tammany,145,38,183,22,3110
31,22005,Ascension,153,170,323,39,110
4-1,22001,Acadia,205,35,240,29,43
7-4,22001,Acadia,371,25,396,47,54
5-4,22001,Acadia,135,44,179,21,55
1-5,22003,Allen,31,31,62,7,63
2-6,22003,Allen,139,32,171,20,73
5-8A,22003,Allen,15,5,20,2,79
1-2,22003,Allen,53,31,84,10,83
5-13,22003,Allen,0,0,0,0,84
4-3,22003,Allen,144,35,179,21,85
5-4-O,22003,Allen,166,21,187,22,86
1-2B,22001,Acadia,201,45,246,29,45
3-3A,22001,Acadia,383,108,491,59,9
2-2-A,22003,Allen,43,31,74,8,6881
3-2,22001,Acadia,327,32,359,43,18
6-9,22001,Acadia,80,33,113,13,30
6-6,22001,Acadia,3,138,141,17,19
1-3B,22001,Acadia,126,102,228,27,52
5-2A,22001,Acadia,141,49,190,22,46
5-1-A,22003,Allen,71,13,84,10,6882
5-7,22003,Allen,0,170,170,20,70
6-2,22001,Acadia,165,38,203,24,27
14,22051,Jefferson,168,58,226,27,1489
6-14,22001,Acadia,237,42,279,33,5
7-2,22001,Acadia,227,35,262,31,32
1-4,22003,Allen,5,127,132,15,81
1-2A,22001,Acadia,125,87,212,25,48
6-3B,22001,Acadia,127,15,142,17,37
6-1,22001,Acadia,108,199,307,37,2
1-4B,22001,Acadia,174,75,249,30,51
5-4-C,22003,Allen,143,36,179,21,65
3-6,22001,Acadia,131,51,182,22,39
6-4,22001,Acadia,167,114,281,34,10
6-3A,22001,Acadia,137,137,274,33,56
6-16,22001,Acadia,122,26,148,17,22
6-11,22001,Acadia,6,271,277,33,47
3-5,22001,Acadia,115,19,134,16,53
6-8,22001,Acadia,176,60,236,28,44
21,22005,Ascension,161,53,214,25,97
6-12,22001,Acadia,194,50,244,29,21
5-8,22003,Allen,21,84,105,12,74
3-3B,22001,Acadia,143,84,227,27,17
6-13,22001,Acadia,128,17,145,17,33
2-4-C,22003,Allen,139,60,199,24,87
51,22005,Ascension,10,325,335,40,117
12,22005,Ascension,479,138,617,74,91
60,22005,Ascension,1,0,1,0,95
5-3,22003,Allen,109,32,141,17,61
1-6,22003,Allen,83,37,120,14,66
2-4-O,22003,Allen,134,110,244,29,88
2-2,22001,Acadia,339,26,365,44,57
2-3,22003,Allen,143,17,160,19,69
1,22005,Ascension,627,156,783,94,103
4,22005,Ascension,305,101,406,49,120
5-12,22003,Allen,15,39,54,6,82
45,22005,Ascension,29,101,130,15,113
1-1,22001,Acadia,407,81,488,59,40
5-1,22007,Assumption,23,201,224,27,155
44,22005,Ascension,56,308,364,44,105
50,22005,Ascension,77,57,134,16,92
5-9,22003,Allen,77,125,202,24,89
1-8,22001,Acadia,185,71,256,30,1
40,22005,Ascension,643,369,1012,122,121
17,22005,Ascension,335,221,556,67,127
8-2A,22009,Avoyelles,79,31,110,13,177
56,22005,Ascension,3,51,54,6,93
9-2,22009,Avoyelles,41,27,68,8,175
9,22005,Ascension,545,208,753,91,108
37,22005,Ascension,67,591,658,79,109
57,22005,Ascension,15,179,194,23,111
28,22005,Ascension,107,137,244,29,145
73,22005,Ascension,124,20,144,17,6886
5-1,22003,Allen,36,24,60,7,71
72,22005,Ascension,230,83,313,37,6885
10-4,22009,Avoyelles,47,338,385,46,174
54,22005,Ascension,127,269,396,47,129
2-3,22007,Assumption,165,133,298,36,149
6-2,22007,Assumption,24,240,264,31,161
42,22005,Ascension,67,120,187,22,131
141,22105,Tangipahoa,156,100,256,30,3213
166W,22019,Calcasieu,244,86,330,39,15217
15,22005,Ascension,345,103,448,54,118
340,22019,Calcasieu,246,118,364,44,15219
372,22019,Calcasieu,476,119,595,71,15220
23,22005,Ascension,134,46,180,21,116
33,22005,Ascension,435,101,536,64,136
7,22005,Ascension,674,226,900,108,143
47,22005,Ascension,32,521,553,66,115
13,22005,Ascension,360,91,451,54,135
26,22005,Ascension,515,172,687,83,137
406,22103,St. Tammany,219,71,290,35,3037
141A,22105,Tangipahoa,166,62,228,27,3163
212A,22051,Jefferson,3,432,435,52,1338
M08,22103,St. Tammany,256,76,332,40,3142
14,22005,Ascension,263,68,331,40,124
8-3A,22009,Avoyelles,293,61,354,42,192
106,22105,Tangipahoa,130,103,233,28,3219
6-7,22001,Acadia,160,31,191,23,50
52,22005,Ascension,104,66,170,20,114
11,22005,Ascension,454,221,675,81,133
53,22005,Ascension,95,138,233,28,119
6-1A,22009,Avoyelles,215,73,288,34,195
2-1,22001,Acadia,365,67,432,52,29
41,22005,Ascension,241,79,320,38,90
48,22005,Ascension,89,61,150,18,100
6,22005,Ascension,942,418,1360,164,104
5-1,22009,Avoyelles,255,74,329,39,182
1-2,22009,Avoyelles,344,46,390,47,185
4-2,22009,Avoyelles,355,91,446,53,189
24,22005,Ascension,115,45,160,19,139
27,22005,Ascension,405,91,496,60,141
18,22005,Ascension,473,144,617,74,126
5-10,22003,Allen,219,34,253,30,78
3-2,22007,Assumption,276,44,320,38,162
5-2,22007,Assumption,204,129,333,40,156
34,22005,Ascension,162,155,317,38,128
7-3,22117,Washington,49,20,69,8,3501
2-8,22009,Avoyelles,29,155,184,22,197
S16,22103,St. Tammany,146,77,223,26,3001
16,22005,Ascension,487,145,632,76,122
2-2A,22009,Avoyelles,124,25,149,18,167
3-1,22007,Assumption,68,33,101,12,163
43,22005,Ascension,310,69,379,45,130
13-12,22071,Orleans,20,163,183,22,2142
58,22005,Ascension,222,136,358,43,138
120,22105,Tangipahoa,343,68,411,49,3194
2-5B,22009,Avoyelles,0,0,0,0,194
4-2,22013,Bienville,40,5,45,5,282
7-1,22013,Bienville,58,95,153,18,285
5,22011,Beauregard,257,33,290,35,216
30,22005,Ascension,62,152,214,25,146
7-1,22009,Avoyelles,176,265,441,53,188
5-3,22007,Assumption,90,32,122,14,158
22,22005,Ascension,194,69,263,31,144
2-4,22009,Avoyelles,151,247,398,48,15209
2-17A,22015,Bossier,53,73,126,15,323
2-4,22069,Natchitoches,91,41,132,15,1952
17-10,22071,Orleans,12,200,212,25,2178
502,22103,St. Tammany,436,112,548,66,3152
4-22,22071,Orleans,177,144,321,38,2070
7-3,22009,Avoyelles,153,41,194,23,207
55,22031,De Soto,68,83,151,18,723
4-1,22009,Avoyelles,153,45,198,23,179
17-13,22071,Orleans,0,201,201,24,2097
37,22067,Morehouse,87,70,157,18,1891
13,22011,Beauregard,128,13,141,17,225
1-1,22009,Avoyelles,324,48,372,45,171
74,22055,Lafayette,189,122,311,37,1589
6-5,22061,Lincoln,0,0,0,0,15865
96,22027,Claiborne,15,13,28,3,689
2-4,22071,Orleans,3,323,326,39,2271
4-1,22013,Bienville,104,191,295,35,261
2-2,22061,Lincoln,43,28,71,8,15864
127,22017,Caddo,149,29,178,21,353
6-11,22097,St. Landry,73,38,111,13,2818
140,22017,Caddo,137,78,215,26,363
1,22011,Beauregard,123,13,136,16,249
12A,22011,Beauregard,127,21,148,17,250
7-2,22081,Red River,32,12,44,5,2586
22,22011,Beauregard,148,16,164,19,251
86,22109,Terrebonne,199,57,256,30,3303
131,22051,Jefferson,16,141,157,18,1487
46,22055,Lafayette,164,67,231,27,1634
39,22113,Vermilion,33,52,85,10,3395
2-3,22115,Vernon,263,20,283,34,3478
7,22011,Beauregard,214,35,249,30,218
22A,22011,Beauregard,84,9,93,11,220
20,22011,Beauregard,257,39,296,35,223
14A,22011,Beauregard,127,13,140,16,231
10,22011,Beauregard,159,22,181,21,237
22,22055,Lafayette,5,186,191,23,1544
4,22011,Beauregard,133,53,186,22,217
15-13B,22071,Orleans,3,333,336,40,2036
32,22087,St. Bernard,143,75,218,26,2691
421,22103,St. Tammany,214,67,281,34,3009
4-3L,22115,Vernon,10,1,11,1,3482
17A,22011,Beauregard,37,2,39,4,240
4-1,22007,Assumption,44,94,138,16,159
11-1,22009,Avoyelles,153,147,300,36,213
1-5,22069,Natchitoches,0,90,90,10,1948
2-2C,22009,Avoyelles,140,54,194,23,191
8-1,22007,Assumption,478,160,638,77,148
109,22017,Caddo,592,137,729,88,402
26,22011,Beauregard,50,160,210,25,236
3,22011,Beauregard,97,18,115,13,258
7-3B,22009,Avoyelles,6,5,11,1,14894
18A,22011,Beauregard,20,0,20,2,233
14,22017,Caddo,194,180,374,45,399
16A,22011,Beauregard,78,24,102,12,246
2-12B,22015,Bossier,83,48,131,15,287
3-1,22013,Bienville,27,188,215,26,277
1-2,22013,Bienville,112,135,247,29,278
6-1,22013,Bienville,106,15,121,14,280
3-3,22071,Orleans,2,8,10,1,2155
2,22011,Beauregard,7,13,20,2,260
11,22011,Beauregard,219,29,248,30,234
19C,22011,Beauregard,102,20,122,14,252
9,22011,Beauregard,180,39,219,26,255
1-7,22115,Vernon,200,37,237,28,3496
27,22011,Beauregard,107,32,139,16,254
19,22011,Beauregard,76,13,89,10,259
2-1,22117,Washington,282,184,466,56,3508
6-4,22013,Bienville,100,14,114,13,283
2-7,22009,Avoyelles,21,137,158,19,187
30,22011,Beauregard,135,56,191,23,232
1-5,22015,Bossier,150,52,202,24,299
4-2A,22009,Avoyelles,131,38,169,20,14896
9-3,22009,Avoyelles,104,42,146,17,14895
2-4A,22009,Avoyelles,248,105,353,42,215
3,22027,Claiborne,125,34,159,19,692
32,22031,De Soto,57,103,160,19,720
14-3,22071,Orleans,56,167,223,26,2037
2-17B,22015,Bossier,68,129,197,23,322
2-13,22015,Bossier,100,137,237,28,288
4-8D,22015,Bossier,45,35,80,9,301
16B,22011,Beauregard,85,15,100,12,229
21,22011,Beauregard,104,27,131,15,224
2-2,22015,Bossier,441,84,525,63,292
4-4B,22015,Bossier,628,116,744,90,296
332S,22019,Calcasieu,110,71,181,21,605
4,22017,Caddo,72,500,572,69,357
18,22011,Beauregard,60,6,66,7,227
28A,22011,Beauregard,8,61,69,8,241
6-3,22013,Bienville,139,69,208,25,262
155,22017,Caddo,67,20,87,10,456
3-2,22015,Bossier,146,100,246,29,348
4-2,22015,Bossier,501,96,597,72,325
6,22011,Beauregard,145,21,166,20,230
2-15,22015,Bossier,29,173,202,24,337
4-9,22015,Bossier,432,127,559,67,342
34,22017,Caddo,19,541,560,67,356
16,22011,Beauregard,189,38,227,27,221
25A,22011,Beauregard,34,29,63,7,222
50B,22113,Vermilion,141,36,177,21,3408
27D,22011,Beauregard,60,6,66,7,238
25,22011,Beauregard,229,91,320,38,226
4-8C,22015,Bossier,64,50,114,13,308
5-1,22013,Bienville,95,180,275,33,265
2-10,22015,Bossier,198,53,251,30,349
12B,22011,Beauregard,229,22,251,30,248
2-2,22013,Bienville,56,137,193,23,286
3-3,22015,Bossier,94,42,136,16,289
4-3C,22015,Bossier,63,26,89,10,294
4-8A,22015,Bossier,338,123,461,55,306
4-8B,22015,Bossier,631,147,778,94,311
28,22011,Beauregard,3,118,121,14,228
4-1A,22015,Bossier,238,99,337,40,313
2-11A,22015,Bossier,39,41,80,9,341
1-3A,22015,Bossier,275,157,432,52,303
2-1,22015,Bossier,189,212,401,48,328
16C,22011,Beauregard,53,2,55,6,257
13A,22011,Beauregard,71,10,81,9,243
3-5,22013,Bienville,23,13,36,4,267
6-2,22013,Bienville,103,1,104,12,279
2-9,22015,Bossier,160,146,306,37,309
69,22017,Caddo,166,327,493,59,379
75,22017,Caddo,513,168,681,82,367
61,22017,Caddo,3,432,435,52,378
98,22017,Caddo,95,83,178,21,375
46,22017,Caddo,19,295,314,37,373
4-11C,22015,Bossier,197,61,258,31,326
4-5A,22015,Bossier,173,68,241,29,327
144,22017,Caddo,204,235,439,53,381
86,22017,Caddo,7,504,511,61,383
4-4,22013,Bienville,210,69,279,33,268
5-4,22013,Bienville,61,10,71,8,270
10,22017,Caddo,295,94,389,47,352
1,22017,Caddo,0,176,176,21,365
16,22017,Caddo,435,132,567,68,394
7-2,22013,Bienville,50,68,118,14,273
15A,22011,Beauregard,25,11,36,4,244
158,22017,Caddo,605,121,726,87,366
5-2,22013,Bienville,163,59,222,26,275
3-4,22013,Bienville,19,31,50,6,269
4-11A,22015,Bossier,304,56,360,43,321
44,22017,Caddo,5,330,335,40,370
48,22017,Caddo,313,85,398,48,406
12,22017,Caddo,334,90,424,51,429
90,22017,Caddo,329,395,724,87,463
26,22017,Caddo,229,104,333,40,447
71,22017,Caddo,2,314,316,38,412
43,22017,Caddo,8,197,205,24,464
74,22017,Caddo,2,162,164,19,428
27,22017,Caddo,197,155,352,42,436
2-18B,22015,Bossier,340,40,380,45,302
37,22017,Caddo,12,344,356,43,376
149,22017,Caddo,100,73,173,20,397
54,22017,Caddo,11,515,526,63,382
156,22017,Caddo,84,89,173,20,415
32,22017,Caddo,29,279,308,37,374
2-20,22015,Bossier,171,79,250,30,333
1-1,22015,Bossier,230,67,297,35,320
80,22017,Caddo,7,341,348,42,361
39,22017,Caddo,2,199,201,24,439
103,22017,Caddo,435,264,699,84,355
2-14,22015,Bossier,98,67,165,19,347
56,22017,Caddo,500,144,644,77,368
40,22017,Caddo,2,223,225,27,362
2-19,22015,Bossier,71,194,265,32,312
2-16,22015,Bossier,178,159,337,40,319
55,22017,Caddo,83,201,284,34,359
15,22011,Beauregard,118,16,134,16,253
2-6,22015,Bossier,39,100,139,16,329
23,22017,Caddo,14,327,341,41,358
132,22017,Caddo,477,133,610,73,380
67,22017,Caddo,1,238,239,28,364
49,22017,Caddo,648,231,879,106,450
95,22017,Caddo,491,242,733,88,386
47,22017,Caddo,234,376,610,73,351
25,22017,Caddo,34,480,514,62,457
146,22017,Caddo,153,54,207,25,403
11,22017,Caddo,451,132,583,70,409
106,22017,Caddo,171,345,516,62,433
53,22017,Caddo,22,314,336,40,472
21,22017,Caddo,309,114,423,51,469
28,22017,Caddo,2,12,14,1,423
143,22017,Caddo,435,117,552,66,398
51,22017,Caddo,11,608,619,74,411
3,22017,Caddo,3,404,407,49,467
60,22017,Caddo,3,389,392,47,473
333,22019,Calcasieu,607,151,758,91,568
701,22019,Calcasieu,8,84,92,11,525
99,22017,Caddo,15,176,191,23,476
92,22017,Caddo,358,143,501,60,440
1-7,22001,Acadia,47,249,296,35,6
45,22017,Caddo,43,623,666,80,446
66,22017,Caddo,427,147,574,69,468
2-21A,22015,Bossier,315,78,393,47,344
135,22017,Caddo,344,181,525,63,387
4-11B,22015,Bossier,525,103,628,75,350
97,22017,Caddo,147,55,202,24,461
82,22017,Caddo,269,221,490,59,478
91,22017,Caddo,441,324,765,92,418
6,22017,Caddo,11,68,79,9,416
102,22017,Caddo,310,125,435,52,465
401,22019,Calcasieu,206,56,262,31,564
130,22017,Caddo,39,17,56,6,466
322,22019,Calcasieu,58,244,302,36,504
139,22017,Caddo,382,70,452,54,407
154,22017,Caddo,25,14,39,4,485
122,22017,Caddo,99,825,924,111,408
35,22017,Caddo,13,298,311,37,371
2,22017,Caddo,288,265,553,66,404
801,22019,Calcasieu,222,77,299,36,511
136,22017,Caddo,777,153,930,112,391
65,22017,Caddo,139,207,346,41,454
123,22017,Caddo,393,142,535,64,431
331,22019,Calcasieu,256,82,338,40,520
87,22017,Caddo,115,426,541,65,420
73,22017,Caddo,3,683,686,83,475
861W,22019,Calcasieu,102,129,231,27,591
364,22019,Calcasieu,134,347,481,58,585
440,22019,Calcasieu,314,178,492,59,599
313W,22019,Calcasieu,0,141,141,17,607
601,22019,Calcasieu,150,34,184,22,581
301,22019,Calcasieu,12,428,440,53,576
762,22019,Calcasieu,103,21,124,15,500
3-1,22015,Bossier,152,95,247,29,339
1-3,22015,Bossier,243,98,341,41,343
460W,22019,Calcasieu,268,45,313,37,502
31,22017,Caddo,10,393,403,48,410
94,22017,Caddo,270,310,580,70,455
159,22017,Caddo,406,282,688,83,460
93,22017,Caddo,301,189,490,59,437
4-10,22015,Bossier,461,141,602,72,334
602,22019,Calcasieu,166,38,204,24,501
366,22019,Calcasieu,237,91,328,39,515
316E,22019,Calcasieu,51,90,141,17,530
325,22019,Calcasieu,403,111,514,62,551
460E,22019,Calcasieu,145,14,159,19,570
400,22019,Calcasieu,247,95,342,41,554
467,22019,Calcasieu,242,96,338,40,505
469,22019,Calcasieu,222,52,274,33,514
58,22017,Caddo,19,360,379,45,486
800,22019,Calcasieu,142,130,272,32,488
304,22019,Calcasieu,14,328,342,41,495
703,22019,Calcasieu,101,37,138,16,494
137,22017,Caddo,259,161,420,50,421
36,22005,Ascension,91,357,448,54,106
6-1,22021,Caldwell,100,11,111,13,621
1,22023,Cameron,55,10,65,7,629
6-1,22025,Catahoula,146,27,173,20,643
5-1,22021,Caldwell,100,17,117,14,611
110,22017,Caddo,361,75,436,52,474
128,22017,Caddo,631,84,715,86,427
164,22019,Calcasieu,124,18,142,17,584
79,22017,Caddo,86,166,252,30,434
129,22017,Caddo,286,194,480,58,435
126,22017,Caddo,222,50,272,32,417
84,22017,Caddo,135,656,791,95,388
313E,22019,Calcasieu,3,45,48,5,592
339,22019,Calcasieu,452,163,615,74,566
311,22019,Calcasieu,5,166,171,20,595
603,22019,Calcasieu,39,102,141,17,603
7-1,22021,Caldwell,121,20,141,17,608
316W,22019,Calcasieu,29,55,84,10,516
36,22017,Caddo,53,415,468,56,445
145,22017,Caddo,12,12,24,2,458
404,22019,Calcasieu,451,116,567,68,492
64,22017,Caddo,31,259,290,35,432
41,22017,Caddo,2,230,232,28,453
464,22019,Calcasieu,348,74,422,51,524
371S,22019,Calcasieu,425,148,573,69,531
660,22019,Calcasieu,400,63,463,56,590
162W,22019,Calcasieu,345,47,392,47,586
663,22019,Calcasieu,87,14,101,12,587
306,22019,Calcasieu,382,120,502,60,557
6-3,22021,Caldwell,69,49,118,14,614
406,22019,Calcasieu,278,92,370,44,560
371N,22019,Calcasieu,99,120,219,26,572
1-2,22021,Caldwell,224,33,257,31,615
8,22017,Caddo,206,216,422,51,442
4-1,22021,Caldwell,24,50,74,8,612
309E,22019,Calcasieu,4,72,76,9,535
335,22019,Calcasieu,273,71,344,41,546
560,22019,Calcasieu,159,40,199,24,556
72,22017,Caddo,244,106,350,42,480
562,22019,Calcasieu,75,8,83,10,518
360,22019,Calcasieu,102,33,135,16,548
6A,22047,Iberville,,,,,1211
327,22019,Calcasieu,67,69,136,16,569
78,22017,Caddo,24,182,206,24,483
318,22019,Calcasieu,88,122,210,25,559
162E,22019,Calcasieu,434,55,489,59,521
302,22019,Calcasieu,35,90,125,15,579
403,22019,Calcasieu,242,120,362,43,537
600,22019,Calcasieu,205,45,250,30,563
305,22019,Calcasieu,6,374,380,45,541
57,22017,Caddo,1,388,389,47,479
326,22019,Calcasieu,310,136,446,53,490
167,22019,Calcasieu,312,66,378,45,491
369,22019,Calcasieu,350,167,517,62,538
330,22019,Calcasieu,32,356,388,46,549
5-2,22021,Caldwell,32,7,39,4,613
300,22019,Calcasieu,16,545,561,67,589
402,22019,Calcasieu,179,58,237,28,582
2-2,22025,Catahoula,144,36,180,21,640
1-1,22025,Catahoula,116,34,150,18,642
6-2,22021,Caldwell,143,10,153,18,616
4-2,22021,Caldwell,28,134,162,19,609
661,22019,Calcasieu,143,38,181,21,596
365,22019,Calcasieu,399,93,492,59,498
77,22017,Caddo,451,135,586,70,471
84,22027,Claiborne,45,84,129,15,670
13,22035,East Carroll,5,171,176,21,968
3-49,22033,East Baton Rouge,586,376,962,116,771
9,22023,Cameron,39,5,44,5,636
77,22051,Jefferson,330,122,452,54,1262
1040,22039,Evangeline,45,80,125,15,1026
177,22051,Jefferson,145,96,241,29,1298
161,22019,Calcasieu,175,35,210,25,598
9-4,22025,Catahoula,39,20,59,7,646
3-1,22025,Catahoula,97,5,102,12,649
465,22019,Calcasieu,138,46,184,22,574
1-2,22025,Catahoula,32,59,91,11,651
329,22019,Calcasieu,89,332,421,50,542
3-2,22033,East Baton Rouge,,,,,869
324,22019,Calcasieu,6,408,414,50,604
3-50,22033,East Baton Rouge,763,370,1133,137,768
461,22019,Calcasieu,164,175,339,41,547
29,22031,De Soto,13,9,22,2,744
1-62,22033,East Baton Rouge,11,460,471,56,888
15,22023,Cameron,44,22,66,7,634
2-1,22025,Catahoula,45,113,158,19,645
2-14,22033,East Baton Rouge,153,315,468,56,870
193B,22051,Jefferson,125,190,315,38,15545
11-3,22045,Iberia,171,90,261,31,1153
10-6,22045,Iberia,71,24,95,11,1156
238B,22051,Jefferson,181,268,449,54,15544
4,22049,Jackson,141,66,207,25,1220
4030,22039,Evangeline,197,37,234,28,1005
29,22047,Iberville,179,139,318,38,1187
4-3,22045,Iberia,34,285,319,38,1141
17A,22047,Iberville,49,26,75,9,1179
3-3A,22125,West Feliciana,37,179,216,26,7198
89,22051,Jefferson,246,100,346,41,1351
5,22035,East Carroll,,,,,975
4B,22041,Franklin,70,27,97,11,1078
14,22067,Morehouse,7,237,244,29,1934
16,22041,Franklin,22,234,256,30,1077
81,22027,Claiborne,45,19,64,7,688
2-22,22033,East Baton Rouge,2,467,469,56,858
6-5,22025,Catahoula,29,7,36,4,644
3-41,22033,East Baton Rouge,790,269,1059,128,872
100,22017,Caddo,67,450,517,62,470
1120,22039,Evangeline,15,183,198,23,1041
4-1,22045,Iberia,8,111,119,14,1127
407,22019,Calcasieu,305,83,388,46,555
160E,22019,Calcasieu,248,38,286,34,545
163,22019,Calcasieu,412,112,524,63,597
1-101,22033,East Baton Rouge,5,323,328,39,789
1-3,22025,Catahoula,3,0,3,0,668
21,22027,Claiborne,25,5,30,3,673
7,22053,Jefferson Davis,286,53,339,41,1521
16,22035,East Carroll,90,21,111,13,969
19,22035,East Carroll,61,42,103,12,971
22,22031,De Soto,208,37,245,29,731
31,22047,Iberville,54,214,268,32,1181
7-37,22071,Orleans,19,201,220,26,2206
1-10A,22069,Natchitoches,,,,,1938
3-31,22033,East Baton Rouge,368,116,484,58,904
1-103,22033,East Baton Rouge,463,188,651,78,935
13-8,22071,Orleans,107,143,250,30,1993
14-13A,22071,Orleans,65,137,202,24,2253
42,22027,Claiborne,79,13,92,11,684
7,22027,Claiborne,247,73,320,38,685
92,22027,Claiborne,120,25,145,17,690
22,22027,Claiborne,54,47,101,12,676
59,22031,De Soto,26,144,170,20,763
1-70,22033,East Baton Rouge,90,694,784,94,874
1-3,22003,Allen,61,54,115,13,80
1-65,22033,East Baton Rouge,149,160,309,37,841
3-38,22033,East Baton Rouge,755,184,939,113,845
1-80,22033,East Baton Rouge,506,245,751,90,863
34,22031,De Soto,58,144,202,24,757
3-4,22025,Catahoula,8,0,8,0,655
15,22035,East Carroll,14,5,19,2,964
3,22035,East Carroll,11,17,28,3,966
1-4,22029,Concordia,22,125,147,17,696
5-3,22029,Concordia,111,20,131,15,706
2-27,22033,East Baton Rouge,36,670,706,85,936
12,22063,Livingston,232,86,318,38,1810
3-52,22033,East Baton Rouge,253,164,417,50,884
3-15,22033,East Baton Rouge,506,147,653,79,885
15,22031,De Soto,24,24,48,5,762
1-46,22033,East Baton Rouge,36,168,204,24,856
3-27,22033,East Baton Rouge,264,310,574,69,925
22,22051,Jefferson,65,42,107,12,1318
2-8,22033,East Baton Rouge,,,,,778
1-4,22025,Catahoula,47,2,49,5,665
3-3,22025,Catahoula,0,0,0,0,667
1-81,22033,East Baton Rouge,132,346,478,57,839
2-30,22033,East Baton Rouge,16,826,842,101,823
3-8,22033,East Baton Rouge,,,,,790
13A,22041,Franklin,29,3,32,3,3996
12-17,22071,Orleans,8,300,308,37,2181
2-9,22069,Natchitoches,231,37,268,32,1946
9-6C,22071,Orleans,0,55,55,6,2034
16,22065,Madison,0,5,5,0,1861
13-15,22071,Orleans,21,174,195,23,2278
1-58,22033,East Baton Rouge,28,443,471,56,840
3-26,22033,East Baton Rouge,913,175,1088,131,913
51,22027,Claiborne,44,28,72,8,691
2-7,22033,East Baton Rouge,,,,,909
1-82,22033,East Baton Rouge,106,582,688,83,820
39,22031,De Soto,77,65,142,17,743
12,22035,East Carroll,2,58,60,7,963
51,22031,De Soto,40,19,59,7,719
3-1,22029,Concordia,176,33,209,25,703
1-53,22033,East Baton Rouge,391,146,537,64,942
1-92,22033,East Baton Rouge,6,343,349,42,829
3-47,22033,East Baton Rouge,609,171,780,94,946
91,22027,Claiborne,29,2,31,3,695
1-18,22033,East Baton Rouge,4,163,167,20,770
1-27,22033,East Baton Rouge,7,469,476,57,805
15-11,22071,Orleans,2,228,230,27,2001
188,22051,Jefferson,12,289,301,36,1416
4B,22063,Livingston,178,21,199,24,8156
10,22065,Madison,62,48,110,13,1863
11-3,22071,Orleans,10,97,107,12,2090
2-18,22033,East Baton Rouge,835,582,1417,171,851
3-9,22033,East Baton Rouge,,,,,837
1-97,22033,East Baton Rouge,97,220,317,38,871
1-88,22033,East Baton Rouge,82,734,816,98,817
2-1,22003,Allen,87,52,139,16,62
3-1,22003,Allen,148,16,164,19,68
1-45,22033,East Baton Rouge,5,274,279,33,854
1-35,22033,East Baton Rouge,173,156,329,39,859
3-51,22033,East Baton Rouge,134,62,196,23,822
23,22067,Morehouse,91,29,120,14,1905
17-18,22071,Orleans,157,96,253,30,2183
1-9,22033,East Baton Rouge,,,,,803
1-2,22033,East Baton Rouge,7,382,389,47,795
32,22051,Jefferson,332,137,469,56,1306
13-KA,22051,Jefferson,168,111,279,33,1283
1-63,22033,East Baton Rouge,2,488,490,59,919
2-11,22033,East Baton Rouge,27,318,345,41,868
9,22031,De Soto,27,120,147,17,729
11,22031,De Soto,182,46,228,27,733
1-93,22033,East Baton Rouge,24,126,150,18,877
4,22031,De Soto,1,80,81,9,717
19A,22047,Iberville,2,27,29,3,1198
42,22051,Jefferson,244,136,380,45,1316
48,22031,De Soto,52,36,88,10,749
42,22031,De Soto,10,41,51,6,751
57,22031,De Soto,50,35,85,10,756
4-2,22003,Allen,188,7,195,23,60
13C,22047,Iberville,4,98,102,12,1190
20,22047,Iberville,70,100,170,20,1196
5A,22035,East Carroll,11,4,15,1,962
15,22047,Iberville,3,395,398,48,1182
18,22047,Iberville,154,105,259,31,1173
1-19,22033,East Baton Rouge,11,232,243,29,799
1-66,22033,East Baton Rouge,208,251,459,55,801
80,22051,Jefferson,161,81,242,29,1346
1-57,22033,East Baton Rouge,119,124,243,29,901
3-22,22033,East Baton Rouge,391,75,466,56,910
2-24,22033,East Baton Rouge,3,351,354,42,876
8,22049,Jackson,99,52,151,18,1215
3-17,22033,East Baton Rouge,600,183,783,94,852
1-16,22033,East Baton Rouge,5,335,340,41,918
11-5,22061,Lincoln,33,56,89,10,15859
8,22053,Jefferson Davis,46,61,107,12,1524
22,22049,Jackson,128,78,206,24,1227
1-67,22033,East Baton Rouge,9,213,222,26,911
4-2,22029,Concordia,191,126,317,38,702
1-37,22033,East Baton Rouge,98,370,468,56,906
1-31,22033,East Baton Rouge,28,532,560,67,824
1-2,22029,Concordia,6,167,173,20,712
1-40,22033,East Baton Rouge,139,209,348,42,920
51,22051,Jefferson,308,128,436,52,1336
2-2,22033,East Baton Rouge,,,,,818
1-34,22033,East Baton Rouge,504,171,675,81,776
33,22031,De Soto,168,169,337,40,718
56,22031,De Soto,57,54,111,13,728
31,22031,De Soto,27,66,93,11,730
46,22031,De Soto,203,54,257,31,732
63,22051,Jefferson,215,70,285,34,1334
9-H,22051,Jefferson,165,76,241,29,1339
1-4,22033,East Baton Rouge,3,186,189,22,800
9-2,22025,Catahoula,98,27,125,15,659
23,22031,De Soto,522,100,622,75,739
53,22031,De Soto,26,11,37,4,740
1-3,22029,Concordia,309,103,412,49,709
4-1,22029,Concordia,57,42,99,11,714
5-1,22025,Catahoula,213,35,248,30,641
4-4,22029,Concordia,117,177,294,35,15537
7-18,22071,Orleans,27,344,371,44,2095
11,22047,Iberville,26,354,380,45,1186
3-2,22029,Concordia,147,36,183,22,15539
84,22051,Jefferson,165,68,233,28,1303
1-60,22033,East Baton Rouge,417,310,727,87,838
63,22031,De Soto,28,225,253,30,754
72,22051,Jefferson,186,71,257,31,1304
2-31,22033,East Baton Rouge,28,166,194,23,912
138,22051,Jefferson,19,69,88,10,1312
28,22031,De Soto,111,19,130,15,725
1-77,22033,East Baton Rouge,13,776,789,95,924
37,22027,Claiborne,2,6,8,0,687
49,22031,De Soto,92,52,144,17,759
121,22051,Jefferson,321,126,447,54,1328
3-3B,22125,West Feliciana,3,80,83,10,7199
1171,22039,Evangeline,98,22,120,14,1033
85,22051,Jefferson,211,110,321,38,1296
1-14,22033,East Baton Rouge,10,635,645,78,922
32,22047,Iberville,66,510,576,69,1176
7,22065,Madison,102,8,110,13,1885
5B,22035,East Carroll,3,5,8,0,960
1-28,22033,East Baton Rouge,16,364,380,45,865
2-19,22033,East Baton Rouge,37,214,251,30,782
1-51,22033,East Baton Rouge,3,326,329,39,881
1-39,22033,East Baton Rouge,273,184,457,55,846
1-1,22033,East Baton Rouge,74,237,311,37,932
5-2,22025,Catahoula,36,5,41,4,657
8-2,22045,Iberia,496,126,622,75,1146
36,22027,Claiborne,48,151,199,24,686
1-55,22033,East Baton Rouge,417,234,651,78,899
1-95,22033,East Baton Rouge,10,593,603,72,786
1010,22039,Evangeline,43,138,181,21,1028
2-26,22033,East Baton Rouge,235,263,498,60,792
4010,22039,Evangeline,94,6,100,12,1004
3-25,22033,East Baton Rouge,602,111,713,86,774
6-15,22001,Acadia,91,13,104,12,26
13,22023,Cameron,65,38,103,12,639
1-90,22033,East Baton Rouge,425,247,672,81,902
7-1,22043,Grant,112,10,122,14,1089
4-W,22051,Jefferson,108,92,200,24,1358
6-G,22051,Jefferson,30,188,218,26,1285
1-47,22033,East Baton Rouge,613,334,947,114,788
1-25,22033,East Baton Rouge,8,476,484,58,915
1-17,22033,East Baton Rouge,20,144,164,19,864
4,22035,East Carroll,15,3,18,2,965
34,22027,Claiborne,26,167,193,23,681
1-71,22033,East Baton Rouge,363,367,730,88,953
3-23,22033,East Baton Rouge,364,443,807,97,895
18,22051,Jefferson,327,134,461,55,1315
1-22,22033,East Baton Rouge,7,167,174,21,907
1-86,22033,East Baton Rouge,8,587,595,71,896
7-3,22025,Catahoula,40,26,66,7,662
3-10,22033,East Baton Rouge,512,257,769,93,779
3-4,22001,Acadia,36,267,303,36,42
1-8,22069,Natchitoches,2,178,180,21,1981
1-74,22033,East Baton Rouge,539,161,700,84,860
1-94,22033,East Baton Rouge,0,249,249,30,917
20-K,22051,Jefferson,408,169,577,69,1266
1,22027,Claiborne,167,95,262,31,678
93,22027,Claiborne,21,125,146,17,679
185A,22051,Jefferson,158,89,247,29,1259
1-1,22043,Grant,93,36,129,15,1098
2-2,22021,Caldwell,126,23,149,18,619
11,22035,East Carroll,0,75,75,9,959
1-99,22033,East Baton Rouge,593,299,892,107,835
5-W,22051,Jefferson,282,191,473,57,1369
1-64,22033,East Baton Rouge,115,121,236,28,833
5-7,22029,Concordia,11,3,14,1,15540
3-3,22029,Concordia,228,29,257,31,15541
1-73,22033,East Baton Rouge,216,505,721,87,947
3-43,22033,East Baton Rouge,486,122,608,73,952
5-6,22029,Concordia,252,24,276,33,697
61,22051,Jefferson,256,77,333,40,1305
1-102,22033,East Baton Rouge,119,224,343,41,775
1-1,22029,Concordia,15,326,341,41,707
1-26,22033,East Baton Rouge,7,288,295,35,914
1-91,22033,East Baton Rouge,13,366,379,45,897
3-29,22033,East Baton Rouge,408,158,566,68,934
5,22037,East Feliciana,161,264,425,51,14572
1-105,22033,East Baton Rouge,543,206,749,90,811
30,22031,De Soto,230,64,294,35,766
3-21,22033,East Baton Rouge,413,431,844,102,929
2-20,22033,East Baton Rouge,54,112,166,20,812
1-83,22033,East Baton Rouge,140,252,392,47,831
41,22027,Claiborne,66,26,92,11,671
6,22031,De Soto,9,162,171,20,752
13A,22035,East Carroll,4,63,67,8,958
21,22031,De Soto,124,65,189,22,755
88,22027,Claiborne,75,32,107,12,674
5,22031,De Soto,43,173,216,26,761
2-1,22021,Caldwell,110,19,129,15,626
1-100,22033,East Baton Rouge,2,155,157,18,809
2-3,22033,East Baton Rouge,,,,,828
2-23,22033,East Baton Rouge,8,491,499,60,878
9-3,22025,Catahoula,55,19,74,8,661
5-2,22003,Allen,290,54,344,41,75
1-33,22033,East Baton Rouge,166,139,305,36,928
2-1,22045,Iberia,52,178,230,27,1135
4-1,22025,Catahoula,52,36,88,10,664
3-32,22033,East Baton Rouge,488,453,941,113,890
2-6,22033,East Baton Rouge,,,,,853
14A,22035,East Carroll,5,13,18,2,967
15A,22047,Iberville,16,3,19,2,1191
19,22051,Jefferson,143,67,210,25,1307
1-48,22033,East Baton Rouge,563,299,862,104,814
3-K,22051,Jefferson,205,158,363,43,1273
6-2,22025,Catahoula,32,5,37,4,652
1-7,22033,East Baton Rouge,121,215,336,40,825
11,22027,Claiborne,39,38,77,9,680
7-40,22071,Orleans,58,263,321,38,2197
1-85,22033,East Baton Rouge,6,749,755,91,783
3-46,22033,East Baton Rouge,532,60,592,71,821
3-33,22033,East Baton Rouge,641,217,858,103,847
10,22027,Claiborne,5,77,82,9,683
2-9,22033,East Baton Rouge,,,,,832
3-7,22033,East Baton Rouge,,,,,905
1-38,22033,East Baton Rouge,34,391,425,51,943
1-3,22033,East Baton Rouge,15,174,189,22,769
17,22035,East Carroll,28,20,48,5,957
3-53,22033,East Baton Rouge,364,118,482,58,866
1-41,22033,East Baton Rouge,328,229,557,67,867
17,22023,Cameron,52,19,71,8,15226
2,22051,Jefferson,306,115,421,50,1344
9-42C,22071,Orleans,2,307,309,37,2243
9-40,22071,Orleans,6,210,216,26,2044
2-6A,22071,Orleans,0,42,42,5,2225
9-45,22071,Orleans,126,72,198,23,2040
10-11,22071,Orleans,16,220,236,28,2021
3-55,22033,East Baton Rouge,11,416,427,51,848
7-1,22025,Catahoula,4,135,139,16,666
3-19,22033,East Baton Rouge,743,133,876,105,773
20,22049,Jackson,2,35,37,4,1224
3-40,22033,East Baton Rouge,563,200,763,92,893
2-25,22033,East Baton Rouge,175,643,818,98,807
76,22051,Jefferson,319,200,519,62,1325
363,22019,Calcasieu,737,140,877,106,580
3,22041,Franklin,181,31,212,25,1083
2-1,22033,East Baton Rouge,,,,,796
5-3,22045,Iberia,77,131,208,25,1138
30,22051,Jefferson,355,143,498,60,1263
183,22051,Jefferson,98,117,215,26,1363
128,22051,Jefferson,160,116,276,33,1337
101,22051,Jefferson,119,42,161,19,1373
7-2,22045,Iberia,188,39,227,27,1121
8-H,22051,Jefferson,436,128,564,68,1371
2-5,22033,East Baton Rouge,,,,,955
12-6,22071,Orleans,41,164,205,24,2051
3-34,22033,East Baton Rouge,363,151,514,62,806
2,22041,Franklin,116,10,126,15,1079
127,22051,Jefferson,137,130,267,32,1317
1-78,22033,East Baton Rouge,61,436,497,60,819
1-6,22033,East Baton Rouge,7,214,221,26,794
9-1,22025,Catahoula,35,4,39,4,656
1-10,22033,East Baton Rouge,4,461,465,56,923
1-98,22033,East Baton Rouge,515,333,848,102,772
2,22047,Iberville,23,313,336,40,1199
2-12C,22015,Bossier,72,113,185,22,290
12-3,22045,Iberia,29,398,427,51,1164
122,22051,Jefferson,370,125,495,59,1290
20A,22049,Jackson,6,215,221,26,1235
2-K,22051,Jefferson,392,174,566,68,1319
9-11,22071,Orleans,8,134,142,17,2050
3-9,22069,Natchitoches,43,0,43,5,1967
3-2,22069,Natchitoches,85,17,102,12,1969
1-49,22033,East Baton Rouge,455,162,617,74,898
232A,22051,Jefferson,48,218,266,32,1320
13A,22047,Iberville,18,4,22,2,1212
33,22051,Jefferson,210,92,302,36,1399
1-GI,22051,Jefferson,146,149,295,35,1359
3-2,22043,Grant,54,80,134,16,1107
214B,22051,Jefferson,10,317,327,39,1383
9-10,22071,Orleans,6,311,317,38,2139
3-16,22033,East Baton Rouge,974,181,1155,139,784
7-3,22045,Iberia,343,58,401,48,1132
25B,22047,Iberville,70,17,87,10,1185
187,22051,Jefferson,3,748,751,90,1268
45,22067,Morehouse,204,44,248,30,1903
26A,22049,Jackson,15,8,23,2,1240
9-2,22045,Iberia,298,72,370,44,1157
1-43,22033,East Baton Rouge,319,126,445,53,857
4-9,22069,Natchitoches,113,99,212,25,1974
202,22051,Jefferson,148,105,253,30,1284
11-1,22045,Iberia,130,60,190,22,1131
26A,22047,Iberville,81,24,105,12,1200
106,22051,Jefferson,165,46,211,25,1345
1-56,22033,East Baton Rouge,625,221,846,102,951
1-24,22033,East Baton Rouge,12,413,425,51,954
9-3,22045,Iberia,149,57,206,24,1147
136,22051,Jefferson,110,133,243,29,1391
17,22047,Iberville,214,65,279,33,1214
10-3,22045,Iberia,292,58,350,42,1151
25A,22047,Iberville,36,30,66,7,1174
247,22051,Jefferson,161,160,321,38,1276
19-K,22051,Jefferson,383,135,518,62,1269
10,22047,Iberville,532,551,1083,131,1178
9-13,22071,Orleans,6,150,156,18,2005
14-18A,22071,Orleans,95,153,248,30,2015
11,22065,Madison,32,11,43,5,1868
1130,22039,Evangeline,234,34,268,32,1020
1140,22039,Evangeline,182,23,205,24,1022
9,22051,Jefferson,190,145,335,40,1387
3-4,22045,Iberia,89,38,127,15,1117
1162,22039,Evangeline,14,41,55,6,1040
8-7,22071,Orleans,2,140,142,17,2145
16-9,22071,Orleans,9,135,144,17,2055
1-68,22033,East Baton Rouge,0,212,212,25,816
14,22047,Iberville,111,93,204,24,1202
9-1,22045,Iberia,186,173,359,43,1152
1050,22039,Evangeline,66,19,85,10,1016
24,22041,Franklin,40,265,305,36,1069
3020,22039,Evangeline,123,130,253,30,1023
8A,22049,Jackson,,,,,1222
3-44,22033,East Baton Rouge,163,558,721,87,802
5004,22039,Evangeline,139,16,155,18,1009
1,22047,Iberville,42,37,79,9,1171
1-9A,22069,Natchitoches,82,38,120,14,1984
4A,22035,East Carroll,6,1,7,0,976
228,22051,Jefferson,192,253,445,53,1400
19,22047,Iberville,3,202,205,24,1209
5050,22039,Evangeline,39,4,43,5,1011
4-1,22069,Natchitoches,39,54,93,11,1983
1110,22039,Evangeline,8,316,324,39,1056
6,22067,Morehouse,81,18,99,11,1892
9-43J,22071,Orleans,1,160,161,19,2151
16A,22023,Cameron,112,17,129,15,6876
2-4,22033,East Baton Rouge,,,,,887
1101,22039,Evangeline,66,86,152,18,1048
71,22005,Ascension,467,277,744,90,6884
28,22047,Iberville,28,2,30,3,1197
10-2,22045,Iberia,163,89,252,30,1140
15B,22047,Iberville,74,63,137,16,1205
16-4,22071,Orleans,39,200,239,28,2149
2020,22039,Evangeline,94,36,130,15,1054
235,22051,Jefferson,56,155,211,25,1295
25,22041,Franklin,3,82,85,10,1063
4,22041,Franklin,65,203,268,32,1087
24,22047,Iberville,173,173,346,41,1188
8-23,22071,Orleans,35,249,284,34,2024
9-31D,22071,Orleans,2,279,281,34,2202
1020,22039,Evangeline,83,24,107,12,1055
21,22041,Franklin,193,27,220,26,1082
26,22047,Iberville,119,22,141,17,1201
12-4,22071,Orleans,19,164,183,22,2041
9-3A,22071,Orleans,1,84,85,10,2234
5-15,22071,Orleans,110,319,429,51,2236
14-1,22071,Orleans,61,143,204,24,2118
2,22067,Morehouse,5,13,18,2,1904
13-4,22045,Iberia,141,22,163,19,1142
1-72,22033,East Baton Rouge,414,208,622,75,891
238A,22051,Jefferson,149,361,510,61,15543
193A,22051,Jefferson,101,232,333,40,15546
664,22019,Calcasieu,286,60,346,41,578
67,22051,Jefferson,83,31,114,13,1249
105,22051,Jefferson,122,38,160,19,1277
7-4,22071,Orleans,5,152,157,18,2017
14,22035,East Carroll,,,,,973
1-G,22051,Jefferson,80,45,125,15,1287
11-4,22045,Iberia,58,151,209,25,1128
21,22047,Iberville,166,174,340,41,1204
86,22051,Jefferson,136,85,221,26,1291
9-44G,22071,Orleans,3,255,258,31,2180
6,22047,Iberville,10,67,77,9,1194
4,22047,Iberville,347,81,428,51,1195
7,22041,Franklin,57,32,89,10,1067
9-40A,22071,Orleans,9,295,304,36,2103
15-19,22071,Orleans,1,323,324,39,2165
3040,22039,Evangeline,247,78,325,39,1014
10,22051,Jefferson,235,82,317,38,1365
64,22051,Jefferson,145,52,197,23,1379
75,22051,Jefferson,158,73,231,27,1401
16,22047,Iberville,1,353,354,42,1206
2030,22039,Evangeline,119,23,142,17,1032
4020,22039,Evangeline,87,10,97,11,1059
13,22041,Franklin,169,25,194,23,1061
1,22041,Franklin,90,33,123,14,1064
7-G,22051,Jefferson,31,380,411,49,1272
11-11,22071,Orleans,6,204,210,25,2242
4,22065,Madison,46,13,59,7,1866
11-8,22071,Orleans,76,109,185,22,2069
13-1,22071,Orleans,8,179,187,22,2075
8-22,22071,Orleans,26,181,207,25,2261
184,22051,Jefferson,406,230,636,76,1258
1-69,22033,East Baton Rouge,412,292,704,85,930
3-39,22033,East Baton Rouge,31,108,139,16,855
1-87,22033,East Baton Rouge,420,335,755,91,948
3032,22039,Evangeline,73,24,97,11,1027
5040,22039,Evangeline,156,20,176,21,1029
5-2,22043,Grant,174,25,199,24,1099
3-W,22051,Jefferson,128,114,242,29,1356
200,22051,Jefferson,5,404,409,49,1361
31,22041,Franklin,320,45,365,44,1085
25,22047,Iberville,218,55,273,33,1189
6,22041,Franklin,270,53,323,39,1066
3,22047,Iberville,44,387,431,52,1183
2-1,22043,Grant,49,6,55,6,1094
189,22051,Jefferson,311,240,551,66,1396
33,22041,Franklin,97,18,115,13,1068
28A,22063,Livingston,338,61,399,48,1825
ZZZZZZ,22051,Jefferson,,,,,1292
5N,22023,Cameron,129,16,145,17,6567
6-3,22025,Catahoula,25,4,29,3,654
1-5A,22069,Natchitoches,2,74,76,9,1958
12-7,22071,Orleans,52,116,168,20,2249
7-32,22071,Orleans,46,148,194,23,2125
3071,22039,Evangeline,8,0,8,0,1018
7-2,22075,Plaquemines,61,506,567,68,16178
32A,22087,St. Bernard,114,85,199,24,16495
3052,22039,Evangeline,12,0,12,1,1051
18,22041,Franklin,13,0,13,1,1062
13,22047,Iberville,104,55,159,19,1184
10-7,22045,Iberia,47,11,58,7,1125
3-H,22051,Jefferson,251,68,319,38,1309
210,22051,Jefferson,45,83,128,15,1289
6-1,22045,Iberia,123,170,293,35,1113
15,22049,Jackson,60,29,89,10,1226
12-5,22071,Orleans,60,158,218,26,2007
6-3,22043,Grant,82,14,96,11,1111
22,22047,Iberville,480,346,826,99,1210
1-30,22033,East Baton Rouge,5,384,389,47,900
157A,22051,Jefferson,215,384,599,72,1329
1060,22039,Evangeline,118,16,134,16,1049
7-2,22043,Grant,99,10,109,13,1091
108,22051,Jefferson,3,225,228,27,1251
14-3,22045,Iberia,173,77,250,30,1161
82,22051,Jefferson,250,151,401,48,1260
1-1,22045,Iberia,7,293,300,36,1118
15-14F,22071,Orleans,46,182,228,27,2132
3-20,22033,East Baton Rouge,737,636,1373,166,889
2-17,22033,East Baton Rouge,100,307,407,49,892
2-W,22051,Jefferson,7,133,140,16,1265
7-1,22045,Iberia,291,101,392,47,1112
246,22051,Jefferson,152,62,214,25,1342
103,22051,Jefferson,271,79,350,42,1392
2-16,22033,East Baton Rouge,5,594,599,72,931
7-4,22045,Iberia,315,42,357,43,1168
213B,22051,Jefferson,158,152,310,37,1281
204,22051,Jefferson,293,174,467,56,1278
1-36,22033,East Baton Rouge,46,341,387,46,880
15-K,22051,Jefferson,97,147,244,29,1282
2010,22039,Evangeline,207,22,229,27,1050
1170,22039,Evangeline,23,113,136,16,1058
1-2,22045,Iberia,18,239,257,31,1139
4-4,22045,Iberia,81,121,202,24,1165
1150,22039,Evangeline,173,38,211,25,1007
3070,22039,Evangeline,94,18,112,13,1013
15-14G,22071,Orleans,23,310,333,40,2160
92,22051,Jefferson,207,78,285,34,1343
1081,22039,Evangeline,12,112,124,15,1031
12,22051,Jefferson,392,145,537,64,1420
1-3,22045,Iberia,129,123,252,30,1162
2,22035,East Carroll,125,16,141,17,977
7,22047,Iberville,39,283,322,38,1180
1030,22039,Evangeline,189,35,224,27,1006
8,22023,Cameron,23,5,28,3,638
9,22035,East Carroll,15,88,103,12,956
91,22051,Jefferson,159,95,254,30,1322
16C,22023,Cameron,44,8,52,6,6875
16B,22023,Cameron,148,27,175,21,6877
16D,22023,Cameron,58,15,73,8,15224
1080,22039,Evangeline,50,86,136,16,1036
9-4,22061,Lincoln,35,44,79,9,15866
1-W,22051,Jefferson,82,130,212,25,1286
1-89,22033,East Baton Rouge,355,128,483,58,894
3060,22039,Evangeline,25,167,192,23,1012
61,22031,De Soto,4,13,17,2,722
20,22041,Franklin,56,177,233,28,1074
3-6,22033,East Baton Rouge,,,,,873
3-1,22045,Iberia,206,77,283,34,1160
199,22051,Jefferson,204,210,414,50,1253
170,22051,Jefferson,235,173,408,49,1279
8-2,22075,Plaquemines,76,95,171,20,16177
14,22041,Franklin,185,87,272,32,1086
3A,22063,Livingston,349,31,380,45,1811
6-W,22051,Jefferson,127,110,237,28,1333
14-1,22045,Iberia,380,65,445,53,1150
134,22051,Jefferson,103,182,285,34,1246
21,22051,Jefferson,200,85,285,34,1327
4-2,22045,Iberia,54,226,280,33,1143
132,22051,Jefferson,63,101,164,19,1324
216A,22051,Jefferson,71,688,759,91,1300
12,22047,Iberville,18,15,33,3,1213
3,22049,Jackson,172,10,182,22,1216
18,22049,Jackson,121,30,151,18,1217
17A,22049,Jackson,16,37,53,6,1218
3-4,22033,East Baton Rouge,,,,,883
3-28,22033,East Baton Rouge,372,212,584,70,926
1-13,22033,East Baton Rouge,5,122,127,15,875
3-2,22025,Catahoula,178,25,203,24,658
9-G,22051,Jefferson,219,133,352,42,1288
27,22047,Iberville,244,44,288,34,1193
7,22051,Jefferson,247,108,355,42,1299
185B,22051,Jefferson,102,143,245,29,1313
1-2,22043,Grant,104,32,136,16,1102
29-K,22051,Jefferson,148,152,300,36,1271
8,22035,East Carroll,3,43,46,5,972
22,22041,Franklin,85,27,112,13,1075
4A,22041,Franklin,13,3,16,1,1073
14A,22047,Iberville,17,59,76,9,1207
248,22051,Jefferson,106,133,239,28,1368
41,22051,Jefferson,210,84,294,35,1375
174,22051,Jefferson,36,54,90,10,1381
19,22065,Madison,6,46,52,6,1884
1-6,22069,Natchitoches,54,105,159,19,1960
7-5,22045,Iberia,110,8,118,14,1169
1041,22039,Evangeline,182,53,235,28,1038
5010,22039,Evangeline,115,50,165,19,1039
196,22051,Jefferson,71,560,631,76,1427
3-3,22057,Lafourche,363,152,515,62,1672
84,22055,Lafayette,521,124,645,78,1632
18,22077,Pointe Coupee,264,111,375,45,2457
7,22055,Lafayette,268,324,592,71,1582
338,22019,Calcasieu,286,136,422,51,544
2-7,22057,Lafourche,31,246,277,33,1659
S7,22079,Rapides,,,,,2504
S26,22079,Rapides,317,46,363,43,2507
15-18A,22071,Orleans,91,209,300,36,2325
54,22073,Ouachita,551,105,656,79,2363
S25,22079,Rapides,213,137,350,42,2521
56,22073,Ouachita,714,75,789,95,2365
1-3,22057,Lafourche,515,297,812,98,1702
13-3,22045,Iberia,197,31,228,27,1129
4-1,22057,Lafourche,342,136,478,57,1686
74,22051,Jefferson,243,163,406,49,1508
95,22051,Jefferson,286,109,395,47,1418
16-K,22051,Jefferson,238,162,400,48,1497
32,22063,Livingston,247,102,349,42,1842
6-2,22061,Lincoln,22,19,41,4,1779
54,22087,St. Bernard,108,157,265,32,2689
3-G,22051,Jefferson,219,170,389,47,1475
13,22017,Caddo,511,158,669,80,377
98,22055,Lafayette,558,130,688,83,1645
58,22073,Ouachita,394,29,423,51,2368
8-2,22085,Sabine,101,169,270,32,2652
21,22087,St. Bernard,64,53,117,14,2703
5-12,22071,Orleans,36,208,244,29,2293
7-14,22071,Orleans,0,222,222,26,2297
1-2,22095,St. John the Baptist,8,471,479,57,2797
9-8,22071,Orleans,0,96,96,11,2296
1-2,22071,Orleans,26,99,125,15,2304
179A,22051,Jefferson,250,355,605,73,1415
10-5,22057,Lafourche,84,52,136,16,1710
45,22051,Jefferson,189,119,308,37,1438
82,22055,Lafayette,366,155,521,63,1618
102,22055,Lafayette,698,133,831,100,1588
15,22055,Lafayette,15,258,273,33,1576
55,22055,Lafayette,159,309,468,56,1583
3-2,22099,St. Martin,30,111,141,17,2911
81,22055,Lafayette,233,32,265,32,1601
6-2,22057,Lafourche,366,127,493,59,1691
10-4,22057,Lafourche,80,38,118,14,1696
39,22073,Ouachita,408,169,577,69,2412
3-2,22059,La Salle,120,14,134,16,1719
4-3,22061,Lincoln,316,24,340,41,1783
13A,22063,Livingston,157,30,187,22,1790
201,22051,Jefferson,2,484,486,58,1439
94,22051,Jefferson,337,129,466,56,1414
7-2,22071,Orleans,23,174,197,23,2064
7-33,22071,Orleans,20,104,124,15,2072
35,22067,Morehouse,190,53,243,29,1898
3-1,22097,St. Landry,234,58,292,35,2890
12,22087,St. Bernard,67,65,132,15,2700
11-3,22057,Lafourche,478,165,643,77,1707
83,22055,Lafayette,582,136,718,86,1539
6,22055,Lafayette,526,153,679,82,1541
14-10,22071,Orleans,123,167,290,35,2298
41,22055,Lafayette,220,120,340,41,1637
4-1,22061,Lincoln,129,17,146,17,1780
38,22051,Jefferson,232,109,341,41,1452
133,22051,Jefferson,22,253,275,33,1412
33-K,22051,Jefferson,15,251,266,32,1440
7-4,22089,St. Charles,162,315,477,57,2708
2-9,22057,Lafourche,28,259,287,34,1676
9-K,22051,Jefferson,220,71,291,35,1501
14-8,22071,Orleans,105,130,235,28,2088
7-34,22071,Orleans,8,77,85,10,2089
52,22055,Lafayette,55,192,247,29,1567
76,22055,Lafayette,402,91,493,59,1545
59,22051,Jefferson,262,113,375,45,1409
1-10,22097,St. Landry,329,136,465,56,2845
2-3,22095,St. John the Baptist,179,241,420,50,2807
2-1,22097,St. Landry,63,344,407,49,2831
1-1,22091,St. Helena,202,287,489,59,2749
3-3,22091,St. Helena,15,14,29,3,2750
8-13,22071,Orleans,0,155,155,18,2230
9-3,22099,St. Martin,333,237,570,68,2917
99,22055,Lafayette,169,233,402,48,1622
31,22055,Lafayette,347,116,463,56,1586
2-5,22085,Sabine,77,20,97,11,2636
88,22051,Jefferson,205,75,280,33,1448
40,22051,Jefferson,185,88,273,33,1479
4-5,22097,St. Landry,123,10,133,16,2895
52,22051,Jefferson,397,155,552,66,1499
90,22055,Lafayette,228,85,313,37,1615
11,22073,Ouachita,16,342,358,43,2404
15,22051,Jefferson,126,58,184,22,1504
17-20,22071,Orleans,193,142,335,40,2062
5,22051,Jefferson,246,75,321,38,1477
11-K,22051,Jefferson,149,109,258,31,1471
7-1,22059,La Salle,249,19,268,32,1722
57,22087,St. Bernard,12,17,29,3,2681
S21,22079,Rapides,215,16,231,27,2489
107,22055,Lafayette,461,64,525,63,1554
6-2,22091,St. Helena,125,17,142,17,2744
215,22051,Jefferson,298,425,723,87,1431
109,22055,Lafayette,694,103,797,96,1542
102,22051,Jefferson,148,85,233,28,1459
63,22017,Caddo,100,171,271,32,401
69,22051,Jefferson,223,97,320,38,1462
11,22055,Lafayette,285,329,614,74,1638
42,22101,St. Mary,180,74,254,30,2997
35-K,22051,Jefferson,211,75,286,34,1446
96,22055,Lafayette,,,,,1546
151,22051,Jefferson,201,464,665,80,1465
1-3,22061,Lincoln,4,42,46,5,1763
56,22087,St. Bernard,7,35,42,5,2684
23,22087,St. Bernard,18,44,62,7,2695
122,22105,Tangipahoa,337,49,386,46,3189
15,22087,St. Bernard,12,3,15,1,2696
9-1,22071,Orleans,14,305,319,38,2054
181,22051,Jefferson,18,434,452,54,1455
13-G,22051,Jefferson,156,89,245,29,1417
11-12,22071,Orleans,2,161,163,19,2066
92,22055,Lafayette,378,170,548,66,1643
3-1,22075,Plaquemines,433,138,571,69,2453
5-1B,22057,Lafourche,55,96,151,18,1684
4-4,22001,Acadia,430,57,487,58,58
1-2,22057,Lafourche,90,93,183,22,1685
216B,22051,Jefferson,212,265,477,57,1450
7-12,22071,Orleans,22,232,254,30,2067
24,22049,Jackson,39,3,42,5,1228
4-4,22057,Lafourche,182,110,292,35,1653
45,22109,Terrebonne,231,56,287,34,3299
2-8,22057,Lafourche,154,38,192,23,1688
1-13,22097,St. Landry,74,292,366,44,2867
3-1B,22099,St. Martin,7,7,14,1,2935
3-2A,22127,Winn,6,0,6,0,3637
232B,22051,Jefferson,101,438,539,65,1437
6-2,22097,St. Landry,236,73,309,37,2834
6-3,22061,Lincoln,65,5,70,8,1751
4-3,22059,La Salle,52,7,59,7,1724
8-5,22059,La Salle,36,0,36,4,1725
7-2,22059,La Salle,91,14,105,12,1726
33,22055,Lafayette,559,116,675,81,1633
20,22051,Jefferson,93,38,131,15,1454
12-2,22061,Lincoln,0,0,0,0,1753
5-3,22095,St. John the Baptist,304,318,622,75,2806
37,22055,Lafayette,490,127,617,74,1598
6-4,22061,Lincoln,87,13,100,12,1777
40,22063,Livingston,451,43,494,59,1801
3-12,22071,Orleans,18,371,389,47,2077
7-1,22071,Orleans,52,239,291,35,2272
9-44D,22071,Orleans,13,272,285,34,2279
23,22065,Madison,0,42,42,5,1870
116,22051,Jefferson,131,108,239,28,1264
2-3,22071,Orleans,7,28,35,4,1992
10,22055,Lafayette,188,103,291,35,1560
23-K,22051,Jefferson,35,272,307,37,1512
69,22055,Lafayette,147,89,236,28,1636
23,22055,Lafayette,3,299,302,36,1608
51,22055,Lafayette,5,269,274,33,1626
9-30,22071,Orleans,83,234,317,38,2049
39,22051,Jefferson,246,92,338,40,1441
7-10,22071,Orleans,1,144,145,17,2287
36,22055,Lafayette,507,203,710,85,1614
5,22065,Madison,49,4,53,6,1871
118,22051,Jefferson,284,115,399,48,1432
213A,22051,Jefferson,29,108,137,16,1490
214A,22051,Jefferson,53,79,132,15,1495
18,22093,St. James,161,249,410,49,2760
13,22067,Morehouse,25,243,268,32,1931
1-4,22099,St. Martin,167,54,221,26,2907
5-1,22099,St. Martin,131,28,159,19,2909
3-4,22089,St. Charles,,,,,2711
1-4,22057,Lafourche,27,142,169,20,1668
87,22055,Lafayette,,,,,1604
1-1,22061,Lincoln,5,360,365,44,1770
123,22051,Jefferson,516,176,692,83,1478
2-1,22099,St. Martin,6,333,339,41,2918
35,22051,Jefferson,161,63,224,27,1411
44,22055,Lafayette,216,98,314,37,1617
48,22055,Lafayette,169,87,256,30,1587
36,22051,Jefferson,141,53,194,23,1444
8,22093,St. James,100,40,140,16,2774
14-24A,22071,Orleans,56,235,291,35,2074
41,22087,St. Bernard,140,86,226,27,2702
15-14B,22071,Orleans,55,198,253,30,2308
5-5,22071,Orleans,2,122,124,15,2285
13-14,22071,Orleans,23,208,231,27,2291
2-5,22057,Lafourche,80,117,197,23,1701
236,22051,Jefferson,134,341,475,57,1470
175,22051,Jefferson,122,102,224,27,1464
197B,22051,Jefferson,38,578,616,74,1433
94,22055,Lafayette,497,141,638,77,1572
10-12,22057,Lafourche,137,94,231,27,1705
7-2A,22099,St. Martin,60,10,70,8,2903
7B,22063,Livingston,476,161,637,77,1846
5-1A,22057,Lafourche,152,66,218,26,1651
26,22051,Jefferson,379,188,567,68,1514
8,22005,Ascension,610,181,791,95,123
2-4,22057,Lafourche,118,69,187,22,1674
24,22051,Jefferson,541,178,719,86,1435
10-10,22057,Lafourche,172,96,268,32,1682
55,22051,Jefferson,205,119,324,39,1486
26,22055,Lafayette,211,175,386,46,1570
2-2,22071,Orleans,17,67,84,10,2300
12-G,22051,Jefferson,208,54,262,31,1488
11-3,22061,Lincoln,7,39,46,5,1774
17-13A,22071,Orleans,1,174,175,21,2000
2-4,22099,St. Martin,11,17,28,3,2913
6-6,22097,St. Landry,139,109,248,30,2848
71,22055,Lafayette,221,120,341,41,1648
79,22055,Lafayette,266,55,321,38,1619
3-20,22071,Orleans,19,129,148,17,2045
8-12,22071,Orleans,7,334,341,41,2307
2,22055,Lafayette,705,245,950,114,1605
5-1,22061,Lincoln,210,57,267,32,1761
2-6,22057,Lafourche,162,69,231,27,1673
2-1,22057,Lafourche,75,49,124,15,1690
13-4,22071,Orleans,60,230,290,35,2057
7-W,22051,Jefferson,272,153,425,51,1449
10-G,22051,Jefferson,329,193,522,63,1447
16,22055,Lafayette,41,202,243,29,1644
4-2,22061,Lincoln,119,111,230,27,1758
6-2A,22099,St. Martin,12,24,36,4,2926
119,22051,Jefferson,237,98,335,40,1469
6-4,22057,Lafourche,100,115,215,26,1700
3-4,22057,Lafourche,89,296,385,46,1692
10-5,22061,Lincoln,7,216,223,26,1773
1-H,22051,Jefferson,273,98,371,44,1419
2,22063,Livingston,343,77,420,50,1803
14,22053,Jefferson Davis,239,66,305,36,1536
53,22055,Lafayette,55,219,274,33,1606
9-3,22059,La Salle,49,4,53,6,1743
33,22083,Richland,29,484,513,62,2622
C32,22079,Rapides,195,92,287,34,2530
10-7,22057,Lafourche,27,39,66,7,1655
5-4,22061,Lincoln,222,42,264,31,1757
156,22051,Jefferson,34,568,602,72,1472
58,22055,Lafayette,2,190,192,23,1624
27,22055,Lafayette,193,174,367,44,1550
7-3,22099,St. Martin,45,504,549,66,2901
2-1A,22057,Lafourche,45,61,106,12,1717
4-12A,22097,St. Landry,95,50,145,17,2877
70,22055,Lafayette,190,133,323,39,1620
4-1A,22099,St. Martin,37,37,74,8,2915
2-4A,22057,Lafourche,0,0,0,0,1716
12,22055,Lafayette,404,267,671,81,1612
93,22051,Jefferson,247,70,317,38,1466
5,22055,Lafayette,121,208,329,39,1603
32,22055,Lafayette,480,182,662,80,1561
8-1,22061,Lincoln,79,59,138,16,1762
11-2,22057,Lafourche,474,129,603,72,1694
9-4,22059,La Salle,12,1,13,1,1721
25,22055,Lafayette,134,46,180,21,1552
12-K,22051,Jefferson,472,129,601,72,1484
6-3B,22099,St. Martin,44,16,60,7,2950
7-3,22095,St. John the Baptist,115,99,214,25,2804
27,22051,Jefferson,234,237,471,56,1509
7-1,22085,Sabine,66,9,75,9,2651
54,22055,Lafayette,10,249,259,31,1557
17,22051,Jefferson,443,174,617,74,1425
1-L,22051,Jefferson,267,219,486,58,1456
7-1,22057,Lafourche,60,11,71,8,1698
72,22055,Lafayette,73,49,122,14,1551
3-2,22057,Lafourche,143,77,220,26,1697
10-2,22057,Lafourche,154,69,223,26,1706
6-3,22057,Lafourche,147,118,265,32,1709
227,22051,Jefferson,192,212,404,48,1511
8-9,22071,Orleans,2,244,246,29,2052
60,22055,Lafayette,134,160,294,35,1597
88,22055,Lafayette,378,73,451,54,1646
11-17,22071,Orleans,4,212,216,26,2270
98,22051,Jefferson,353,153,506,61,1506
77,22055,Lafayette,337,74,411,49,1594
1-1,22071,Orleans,32,133,165,19,2047
78,22055,Lafayette,543,134,677,81,1538
194B,22051,Jefferson,242,217,459,55,1476
231,22051,Jefferson,230,276,506,61,1436
86,22055,Lafayette,739,122,861,104,1555
10-8,22057,Lafourche,78,70,148,17,1656
203,22051,Jefferson,138,168,306,37,1423
6-4,22085,Sabine,25,0,25,3,2641
8-3,22099,St. Martin,349,92,441,53,2897
2-1,22061,Lincoln,27,271,298,36,1752
9-2,22061,Lincoln,6,6,12,1,1759
7-3,22057,Lafourche,51,32,83,10,1679
8-6,22059,La Salle,37,7,44,5,1744
104,22017,Caddo,546,93,639,77,419
53,22087,St. Bernard,64,89,153,18,2687
56,22055,Lafayette,13,401,414,50,1581
65,22051,Jefferson,218,85,303,36,1428
6-2,22059,La Salle,98,13,111,13,1727
1-1,22099,St. Martin,198,59,257,31,2943
8-24,22071,Orleans,18,205,223,26,2309
105,22103,St. Tammany,400,112,512,61,3133
16,22093,St. James,46,504,550,66,2757
10-9,22057,Lafourche,143,113,256,30,1704
6-7,22097,St. Landry,491,75,566,68,2830
1,22053,Jefferson Davis,297,150,447,54,1537
7,22067,Morehouse,69,253,322,38,1914
3,22053,Jefferson Davis,121,19,140,16,1520
15-19B,22071,Orleans,2,218,220,26,2184
2040,22039,Evangeline,101,100,201,24,1025
7-29,22071,Orleans,4,187,191,23,2294
3-5,22061,Lincoln,135,26,161,19,1750
4-6,22071,Orleans,10,61,71,8,2079
17-8,22071,Orleans,4,207,211,25,2081
33,22063,Livingston,119,49,168,20,1836
46,22051,Jefferson,117,86,203,24,1366
3-4,22069,Natchitoches,40,53,93,11,1956
2-6,22071,Orleans,0,180,180,21,2091
6-2,22071,Orleans,83,198,281,34,2094
14-19,22071,Orleans,75,160,235,28,2150
27-K,22051,Jefferson,133,80,213,25,1389
3,22055,Lafayette,362,125,487,58,1623
6A,22063,Livingston,227,56,283,34,1843
1B,22063,Livingston,478,47,525,63,1849
38,22063,Livingston,267,236,503,60,1852
16-1A,22071,Orleans,17,133,150,18,2159
1-12,22069,Natchitoches,,,,,1942
9-43M,22071,Orleans,0,244,244,29,2286
9-30A,22071,Orleans,5,169,174,21,2113
26,22065,Madison,0,0,0,0,1886
9-44E,22071,Orleans,10,598,608,73,2172
17-9,22071,Orleans,0,248,248,30,2137
50,22055,Lafayette,10,86,96,11,1577
40,22055,Lafayette,185,70,255,30,1579
4-5,22071,Orleans,7,102,109,13,2290
9-32,22071,Orleans,3,36,39,4,2282
13-3,22071,Orleans,34,176,210,25,2283
14-4,22071,Orleans,57,113,170,20,2065
15-16,22071,Orleans,65,271,336,40,2256
178,22051,Jefferson,98,51,149,18,1370
4-8,22071,Orleans,46,169,215,26,2251
9-25,22071,Orleans,1,334,335,40,2042
2,22049,Jackson,252,15,267,32,1232
2-13,22033,East Baton Rouge,124,337,461,55,882
15-3,22071,Orleans,28,91,119,14,2121
7-21,22071,Orleans,5,245,250,30,2218
17-14,22071,Orleans,1,311,312,37,2233
5C,22063,Livingston,73,15,88,10,8158
3-9,22071,Orleans,7,135,142,17,2105
8,22065,Madison,55,26,81,9,1860
6-1,22071,Orleans,60,137,197,23,2110
7-30,22071,Orleans,18,375,393,47,2129
8-20,22071,Orleans,11,200,211,25,2143
8-28,22071,Orleans,61,257,318,38,2217
35A,22063,Livingston,215,63,278,33,1805
96,22051,Jefferson,126,41,167,20,1390
105,22055,Lafayette,600,83,683,82,1616
2-13,22057,Lafourche,237,127,364,44,1680
17-2,22071,Orleans,25,146,171,20,2277
58,22051,Jefferson,80,54,134,16,1422
7-6,22071,Orleans,16,171,187,22,2275
1D,22063,Livingston,541,48,589,71,1835
4A,22063,Livingston,321,50,371,44,1831
4-18,22071,Orleans,244,135,379,45,2100
57,22051,Jefferson,164,161,325,39,1384
3050,22039,Evangeline,153,12,165,19,1034
29,22017,Caddo,8,346,354,42,424
31-K,22051,Jefferson,7,158,165,19,1460
66,22051,Jefferson,322,157,479,57,1386
10,22063,Livingston,342,56,398,48,1812
18,22063,Livingston,381,74,455,55,1814
8-8,22071,Orleans,5,154,159,19,2022
15-19A,22071,Orleans,242,275,517,62,2115
9-44B,22071,Orleans,2,262,264,31,2255
11-9,22071,Orleans,166,265,431,52,2016
30,22063,Livingston,189,67,256,30,1839
17-17,22071,Orleans,149,107,256,30,2006
57,22055,Lafayette,31,232,263,31,1592
225,22051,Jefferson,30,265,295,35,1360
29,22055,Lafayette,767,206,973,117,1566
15-10,22071,Orleans,0,330,330,39,2252
9-5,22071,Orleans,4,93,97,11,2262
30-K,22051,Jefferson,71,109,180,21,1407
28,22065,Madison,127,39,166,20,1879
48,22067,Morehouse,34,16,50,6,1887
89,22055,Lafayette,326,40,366,44,1574
9-31,22071,Orleans,2,175,177,21,1998
5-9,22071,Orleans,6,142,148,17,2212
9,22065,Madison,11,11,22,2,1859
99,22051,Jefferson,93,53,146,17,1364
12-1,22071,Orleans,21,198,219,26,2168
15-17A,22071,Orleans,74,147,221,26,2175
4,22063,Livingston,459,45,504,60,1804
13,22055,Lafayette,273,249,522,63,1621
7-17,22071,Orleans,29,201,230,27,2138
5A,22063,Livingston,147,9,156,18,1820
130,22051,Jefferson,90,86,176,21,1398
34-K,22051,Jefferson,209,144,353,42,1404
9-14,22071,Orleans,7,145,152,18,2195
31,22067,Morehouse,24,41,65,7,1888
33,22067,Morehouse,25,86,111,13,1896
9-15,22071,Orleans,15,190,205,24,2158
1-6,22071,Orleans,6,195,201,24,2164
38,22055,Lafayette,381,145,526,63,1590
15-18E,22071,Orleans,186,343,529,64,1997
1100,22039,Evangeline,75,33,108,13,1037
17-18A,22071,Orleans,180,108,288,34,2002
15-15A,22071,Orleans,79,218,297,35,2083
11-13,22071,Orleans,0,141,141,17,2131
34,22067,Morehouse,29,50,79,9,1927
17,22067,Morehouse,0,7,7,0,1933
155,22051,Jefferson,102,106,208,25,1382
12-14,22071,Orleans,17,224,241,29,2161
ZZZZZZ,22071,Orleans,,,,,2120
6,22065,Madison,10,5,15,1,1862
21,22065,Madison,3,155,158,19,1874
3-18,22071,Orleans,13,245,258,31,2098
7-16,22071,Orleans,7,209,216,26,2112
104,22051,Jefferson,1,405,406,49,1397
4-14,22071,Orleans,321,210,531,64,2264
7,22063,Livingston,269,47,316,38,1816
5-2,22115,Vernon,131,15,146,17,3444
4-2,22127,Winn,40,7,47,5,3668
12-13,22071,Orleans,4,114,118,14,2153
9-43L,22071,Orleans,3,223,226,27,1989
2-2,22069,Natchitoches,53,17,70,8,1943
5-18,22071,Orleans,165,153,318,38,1994
8B,22063,Livingston,80,19,99,11,1838
41,22063,Livingston,248,33,281,34,1802
5-1,22045,Iberia,96,85,181,21,1158
53,22067,Morehouse,20,44,64,7,1935
15-19C,22071,Orleans,36,453,489,59,2223
9-31A,22071,Orleans,3,264,267,32,2228
1,22063,Livingston,561,89,650,78,1856
15,22063,Livingston,138,38,176,21,1857
120,22051,Jefferson,224,45,269,32,1503
15-14E,22071,Orleans,23,302,325,39,2019
12,22065,Madison,0,107,107,12,1878
1-14,22069,Natchitoches,,,,,1941
4-7,22071,Orleans,23,90,113,13,2157
5S,22023,Cameron,204,34,238,28,6872
7-2,22021,Caldwell,94,9,103,12,617
8,22047,Iberville,3,59,62,7,1172
13B,22063,Livingston,228,36,264,31,1855
5B,22063,Livingston,259,35,294,35,1818
52,22067,Morehouse,7,95,102,12,1908
1031,22039,Evangeline,102,78,180,21,1035
3-6,22069,Natchitoches,143,32,175,21,1940
6-K,22051,Jefferson,330,265,595,71,1498
18,22053,Jefferson Davis,97,26,123,14,1533
9-43B,22071,Orleans,1,214,215,26,2086
9-9,22071,Orleans,12,155,167,20,2038
6-8,22071,Orleans,18,198,216,26,2048
12,22053,Jefferson Davis,175,65,240,29,1516
9A,22053,Jefferson Davis,68,17,85,10,1519
9-38A,22071,Orleans,2,184,186,22,2011
9,22063,Livingston,349,132,481,58,1793
14,22063,Livingston,298,102,400,48,1800
2-4,22085,Sabine,43,28,71,8,2661
6-1,22059,La Salle,168,23,191,23,1729
75,22055,Lafayette,160,66,226,27,1559
5,22049,Jackson,53,120,173,20,1239
16,22049,Jackson,0,73,73,8,1243
17-7,22071,Orleans,20,234,254,30,2093
7-26,22071,Orleans,3,304,307,37,2114
25,22049,Jackson,252,87,339,41,1236
190,22051,Jefferson,322,233,555,67,1388
5-13,22071,Orleans,72,197,269,32,2205
9-8A,22071,Orleans,2,164,166,20,2032
7-5,22071,Orleans,2,199,201,24,2198
15-14A,22071,Orleans,17,167,184,22,2102
29,22051,Jefferson,108,70,178,21,1510
1-3,22069,Natchitoches,28,136,164,19,1985
4-11,22071,Orleans,77,102,179,21,2085
11,22049,Jackson,320,14,334,40,1229
9-3,22071,Orleans,3,177,180,21,2128
12-8,22071,Orleans,45,88,133,16,1991
42,22067,Morehouse,254,18,272,32,1921
13-16,22071,Orleans,36,152,188,22,2003
17-11,22071,Orleans,4,217,221,26,2227
9-43N,22071,Orleans,1,253,254,30,2087
4-15,22071,Orleans,214,150,364,44,2111
16,22067,Morehouse,2,113,115,13,1925
3-36,22033,East Baton Rouge,696,286,982,118,815
15-17,22071,Orleans,112,180,292,35,2258
9-39,22071,Orleans,8,324,332,40,2135
53,22051,Jefferson,279,99,378,45,1406
4-17A,22071,Orleans,155,80,235,28,2013
14-11,22071,Orleans,69,104,173,20,2123
9-19,22071,Orleans,8,188,196,23,2025
157B,22051,Jefferson,0,0,0,0,1362
7-K,22051,Jefferson,404,296,700,84,1374
24,22065,Madison,5,128,133,16,1875
18,22065,Madison,0,21,21,2,1880
25,22067,Morehouse,12,25,37,4,1917
6-4,22071,Orleans,10,171,181,21,2039
12-2,22071,Orleans,33,197,230,27,2141
15-14C,22071,Orleans,52,157,209,25,2146
25-K,22051,Jefferson,233,187,420,50,1494
9-44J,22071,Orleans,19,246,265,32,2004
49,22067,Morehouse,17,15,32,3,1937
27,22065,Madison,6,5,11,1,1883
39A,22063,Livingston,269,66,335,40,1853
23B,22063,Livingston,187,29,216,26,1807
3-48,22033,East Baton Rouge,946,232,1178,142,808
107,22051,Jefferson,1,45,46,5,1493
145,22105,Tangipahoa,487,128,615,74,3178
24,22017,Caddo,229,164,393,47,384
1-3A,22001,Acadia,314,46,360,43,38
23,22053,Jefferson Davis,473,118,591,71,1525
7-41,22071,Orleans,78,118,196,23,2268
6-2,22045,Iberia,171,137,308,37,1134
7-1,22061,Lincoln,150,27,177,21,1781
7,22049,Jackson,27,4,31,3,1225
1-5,22071,Orleans,52,163,215,26,2124
1-13,22069,Natchitoches,,,,,1950
9-35,22071,Orleans,0,93,93,11,2179
13,22053,Jefferson Davis,176,244,420,50,1528
11,22051,Jefferson,213,133,346,41,1421
5-1,22071,Orleans,36,80,116,14,2194
14-5,22071,Orleans,97,129,226,27,2182
1-2,22069,Natchitoches,219,152,371,44,1955
9-33,22071,Orleans,2,348,350,42,2173
47,22067,Morehouse,20,56,76,9,1900
78,22051,Jefferson,295,201,496,60,1250
9-23,22071,Orleans,1,168,169,20,2176
13-10,22071,Orleans,84,131,215,26,2134
12-10,22071,Orleans,74,121,195,23,2191
1-3A,22069,Natchitoches,9,22,31,3,1963
1-11,22069,Natchitoches,,,,,1978
213C,22051,Jefferson,7,122,129,15,1372
12-9,22071,Orleans,26,158,184,22,2280
10-3,22071,Orleans,16,289,305,36,2071
13-2,22071,Orleans,24,199,223,26,2080
6,22063,Livingston,368,70,438,52,1809
24-K,22051,Jefferson,3,139,142,17,1513
10-8,22071,Orleans,59,77,136,16,2201
7-25A,22071,Orleans,9,230,239,28,2208
17-6,22071,Orleans,0,241,241,29,2209
23,22063,Livingston,400,47,447,54,1854
17-12,22071,Orleans,7,176,183,22,2190
115,22051,Jefferson,9,236,245,29,1256
62,22051,Jefferson,182,83,265,32,1261
20,22055,Lafayette,76,426,502,60,1596
11-14,22071,Orleans,2,318,320,38,2199
36A,22063,Livingston,275,30,305,36,1808
14-6,22071,Orleans,124,211,335,40,2220
3-1,22069,Natchitoches,188,19,207,25,1986
4-3,22069,Natchitoches,58,84,142,17,1987
15-18C,22071,Orleans,127,178,305,36,2008
9-38,22071,Orleans,6,176,182,22,2099
9-41A,22071,Orleans,60,54,114,13,2106
14-17,22071,Orleans,55,118,173,20,2108
13-KB,22051,Jefferson,16,125,141,17,1507
1,22067,Morehouse,48,195,243,29,1899
44,22051,Jefferson,264,145,409,49,1443
73,22055,Lafayette,220,54,274,33,1564
9-41,22071,Orleans,52,283,335,40,2226
35,22063,Livingston,248,156,404,48,1837
43,22067,Morehouse,16,2,18,2,1920
8,22055,Lafayette,471,286,757,91,1548
18-K,22051,Jefferson,34,58,92,11,1252
15-15,22071,Orleans,26,269,295,35,2289
4-9,22071,Orleans,190,275,465,56,2215
29,22067,Morehouse,102,58,160,19,1913
18,22067,Morehouse,1,38,39,4,1919
16-5,22071,Orleans,45,200,245,29,2185
9-43E,22071,Orleans,0,164,164,19,2248
26C,22063,Livingston,272,36,308,37,1845
9-43G,22071,Orleans,1,258,259,31,2107
1-10B,22069,Natchitoches,,,,,1961
9-44P,22071,Orleans,33,489,522,63,2023
28B,22063,Livingston,85,9,94,11,1787
9-43C,22071,Orleans,8,368,376,45,2010
1-1,22069,Natchitoches,18,132,150,18,1949
9-2,22075,Plaquemines,137,191,328,39,16180
13-11,22071,Orleans,14,226,240,29,2210
19B,22049,Jackson,16,10,26,3,1223
14-7,22071,Orleans,158,147,305,36,2027
8-4,22071,Orleans,3,118,121,14,2031
81,22051,Jefferson,116,53,169,20,1481
4-4A,22099,St. Martin,44,88,132,15,2898
9-44A,22071,Orleans,10,273,283,34,2263
230,22051,Jefferson,433,202,635,76,1426
3-4A,22099,St. Martin,33,17,50,6,2930
9-43H,22071,Orleans,0,89,89,10,2259
19,22055,Lafayette,16,487,503,60,1565
28-K,22051,Jefferson,105,71,176,21,1491
4-H,22051,Jefferson,356,122,478,57,1500
61,22055,Lafayette,8,123,131,15,1575
212B,22051,Jefferson,0,0,0,0,1395
8-19,22071,Orleans,17,322,339,41,2239
9-45A,22071,Orleans,29,8,37,4,2246
8,22067,Morehouse,101,69,170,20,1902
4-7,22069,Natchitoches,33,5,38,4,1951
79,22051,Jefferson,210,80,290,35,1247
5-10,22071,Orleans,3,119,122,14,2119
16,22063,Livingston,318,150,468,56,1815
8D,22093,St. James,62,31,93,11,16497
A02,22103,St. Tammany,387,181,568,68,16499
9-39B,22071,Orleans,3,155,158,19,2211
6B,22063,Livingston,234,26,260,31,1819
20,22063,Livingston,88,13,101,12,1824
22,22063,Livingston,207,36,243,29,1826
11,22063,Livingston,316,112,428,51,1828
3,22063,Livingston,493,76,569,68,1833
22,22065,Madison,0,62,62,7,1869
15-15B,22071,Orleans,97,111,208,25,2167
2-7,22071,Orleans,2,193,195,23,1999
54,22067,Morehouse,46,8,54,6,1928
1,22051,Jefferson,538,162,700,84,1413
34,22055,Lafayette,428,109,537,64,1569
71,22051,Jefferson,493,158,651,78,1445
4-4,22061,Lincoln,185,25,210,25,1768
3-2,22061,Lincoln,263,52,315,38,1771
5-H,22051,Jefferson,98,48,146,17,1244
9-29,22071,Orleans,8,90,98,11,2171
9-40C,22071,Orleans,13,195,208,25,2216
7-37A,22071,Orleans,14,101,115,13,1990
153,22051,Jefferson,0,546,546,66,1357
10-6,22071,Orleans,15,244,259,31,2078
1-7,22069,Natchitoches,160,109,269,32,1959
1,22049,Jackson,42,2,44,5,1230
1-1A,22069,Natchitoches,51,37,88,10,1966
13,22065,Madison,13,80,93,11,1877
20,22067,Morehouse,58,131,189,22,1926
9-5,22045,Iberia,171,60,231,27,1159
8-30,22071,Orleans,12,306,318,38,2273
9-44,22071,Orleans,7,265,272,32,2187
68,22051,Jefferson,271,131,402,48,1348
7-2,22061,Lincoln,648,155,803,97,1778
3-3,22061,Lincoln,145,60,205,24,1754
103,22055,Lafayette,378,117,495,59,1585
2-7,22069,Natchitoches,14,120,134,16,1970
100,22055,Lafayette,341,57,398,48,1639
9-28E,22071,Orleans,3,164,167,20,2213
14-26,22071,Orleans,4,187,191,23,2076
14-2,22071,Orleans,68,146,214,25,2245
26B,22063,Livingston,344,40,384,46,1796
5-7,22071,Orleans,0,179,179,21,2046
9-44Q,22071,Orleans,2,290,292,35,2033
8-14,22071,Orleans,4,181,185,22,2219
7-13,22071,Orleans,2,176,178,21,2174
15,22065,Madison,9,185,194,23,1882
15-12A,22071,Orleans,6,202,208,25,2188
11-4,22071,Orleans,26,175,201,24,2170
1-19,22097,St. Landry,76,75,151,18,2856
23,22083,Richland,61,6,67,8,2597
7-5A,22115,Vernon,54,27,81,9,3492
6-1,22117,Washington,210,45,255,30,3531
4-5,22061,Lincoln,117,39,156,18,1776
180,22051,Jefferson,2,468,470,56,1496
56,22051,Jefferson,220,141,361,43,1505
4-3E,22115,Vernon,0,0,0,0,3491
137B,22105,Tangipahoa,148,123,271,32,3229
8,22073,Ouachita,492,172,664,80,2424
5-1,22095,St. John the Baptist,53,17,70,8,2805
C9,22079,Rapides,2,168,170,20,2577
307,22103,St. Tammany,353,91,444,53,3102
22,22073,Ouachita,10,448,458,55,2431
15-13A,22071,Orleans,12,272,284,34,2009
50,22073,Ouachita,284,26,310,37,2375
76,22073,Ouachita,329,147,476,57,2427
2-3A,22115,Vernon,80,4,84,10,3493
2-1A,22115,Vernon,66,8,74,8,3494
126,22051,Jefferson,254,172,426,51,1473
7-H,22051,Jefferson,238,83,321,38,1367
3,22065,Madison,127,7,134,16,1873
49B-4,22113,Vermilion,0,0,0,0,14559
9,22049,Jackson,59,83,142,17,1221
3-2,22125,West Feliciana,51,137,188,22,3617
9-1,22085,Sabine,88,83,171,20,2634
C10,22079,Rapides,6,120,126,15,2568
1-2,22059,La Salle,52,2,54,6,1735
4-1,22085,Sabine,68,276,344,41,2645
7-3,22085,Sabine,105,7,112,13,2647
1-1,22085,Sabine,177,9,186,22,2655
26,22113,Vermilion,228,32,260,31,14554
113,22055,Lafayette,207,159,366,44,15549
1,22055,Lafayette,525,190,715,86,1631
3,22077,Pointe Coupee,147,106,253,30,2459
8A,22053,Jefferson Davis,10,86,96,11,15548
3-4,22085,Sabine,56,7,63,7,2656
5-3,22085,Sabine,78,22,100,12,2663
2-6A,22085,Sabine,210,25,235,28,2665
55,22073,Ouachita,476,84,560,67,2402
9A,22073,Ouachita,126,154,280,33,2406
80,22055,Lafayette,330,66,396,47,1609
47,22073,Ouachita,222,80,302,36,2420
5-G,22051,Jefferson,117,60,177,21,1245
419,22103,St. Tammany,325,95,420,50,3044
59,22109,Terrebonne,421,281,702,84,3306
P01,22103,St. Tammany,498,183,681,82,3103
S2,22079,Rapides,,,,,2555
66,22073,Ouachita,23,250,273,33,2366
S23,22079,Rapides,157,23,180,21,2520
34,22063,Livingston,193,67,260,31,1795
43,22073,Ouachita,685,68,753,91,2419
1-2,22075,Plaquemines,25,180,205,24,2454
10B,22077,Pointe Coupee,15,52,67,8,2474
C3,22079,Rapides,2,330,332,40,2575
7-42,22071,Orleans,74,97,171,20,2313
35,22055,Lafayette,336,105,441,53,1630
4-3,22081,Red River,4,119,123,14,2591
28,22073,Ouachita,57,88,145,17,2382
13A,22077,Pointe Coupee,2,347,349,42,2471
121B,22105,Tangipahoa,26,6,32,3,3177
17,22065,Madison,0,12,12,1,1858
3,22119,Webster,26,59,85,10,3566
27,22111,Union,211,22,233,28,3353
32,22109,Terrebonne,93,53,146,17,3305
41,22073,Ouachita,840,85,925,111,2403
C35,22079,Rapides,213,51,264,31,2494
43,22063,Livingston,56,7,63,7,1789
2,22077,Pointe Coupee,17,111,128,15,2467
6-3,22097,St. Landry,119,156,275,33,2894
C8,22079,Rapides,0,117,117,14,2552
C19,22079,Rapides,68,121,189,22,2499
C18,22079,Rapides,110,166,276,33,2502
N9,22079,Rapides,,,,,2565
57,22109,Terrebonne,313,145,458,55,3267
20,22073,Ouachita,21,316,337,40,2416
8,22083,Richland,216,36,252,30,2600
C14,22079,Rapides,47,49,96,11,2519
30,22083,Richland,68,12,80,9,2627
7,22077,Pointe Coupee,97,240,337,40,2476
9-44I,22071,Orleans,9,285,294,35,2318
C5,22079,Rapides,4,206,210,25,2560
15B,22093,St. James,16,24,40,4,2768
12,22093,St. James,46,226,272,32,2775
8-15,22071,Orleans,13,424,437,52,2254
S8,22079,Rapides,,,,,2484
4-7,22015,Bossier,479,259,738,89,335
18,22083,Richland,62,314,376,45,2602
S11,22079,Rapides,231,30,261,31,2525
6,22073,Ouachita,585,100,685,82,2423
6-1,22057,Lafourche,677,240,917,110,1670
2,22053,Jefferson Davis,217,50,267,32,1532
3-4,22061,Lincoln,169,65,234,28,1765
66,22055,Lafayette,47,115,162,19,1650
10-6,22057,Lafourche,67,55,122,14,1657
4-6,22057,Lafourche,238,115,353,42,1658
7-27B,22071,Orleans,1,164,165,19,2329
C6,22079,Rapides,3,351,354,42,2545
6-3A,22099,St. Martin,87,47,134,16,2927
48,22073,Ouachita,251,42,293,35,2434
C09,22103,St. Tammany,349,132,481,58,3013
1-2,22081,Red River,97,26,123,14,2596
2-14,22057,Lafourche,194,60,254,30,1665
C28,22079,Rapides,65,145,210,25,2542
N19,22079,Rapides,534,77,611,73,2562
N6,22079,Rapides,,,,,2567
5-2,22061,Lincoln,309,35,344,41,1785
9-7,22071,Orleans,0,234,234,28,2336
68,22017,Caddo,346,195,541,65,451
8-1,22057,Lafourche,132,75,207,25,1667
14,22087,St. Bernard,93,77,170,20,2692
67,22073,Ouachita,64,85,149,18,2413
9-44F,22071,Orleans,3,432,435,52,2334
68,22073,Ouachita,66,147,213,25,2408
29,22073,Ouachita,17,59,76,9,2421
C31,22079,Rapides,278,88,366,44,2563
27A,22073,Ouachita,6,50,56,6,4632
3-2,22081,Red River,105,26,131,15,2579
49,22073,Ouachita,292,27,319,38,2379
S25,22103,St. Tammany,57,126,183,22,3124
32,22101,St. Mary,318,34,352,42,2988
S24,22079,Rapides,58,19,77,9,2503
11-10,22071,Orleans,45,223,268,32,2345
5-11,22071,Orleans,12,133,145,17,2347
40,22073,Ouachita,164,44,208,25,2376
S20,22079,Rapides,75,242,317,38,2566
5,22073,Ouachita,331,256,587,71,2358
104,22103,St. Tammany,614,163,777,94,3138
71,22073,Ouachita,498,105,603,72,2407
305,22103,St. Tammany,170,141,311,37,3032
6,22077,Pointe Coupee,106,75,181,21,2478
7-4,22085,Sabine,102,12,114,13,2635
2-3,22085,Sabine,32,2,34,4,2637
2-4,22095,St. John the Baptist,239,64,303,36,2810
3-1,22099,St. Martin,12,53,65,7,2908
75,22073,Ouachita,675,97,772,93,2360
11-5,22071,Orleans,63,286,349,42,2348
16-2,22071,Orleans,71,151,222,26,2349
8-1,22071,Orleans,20,186,206,24,2344
12-11,22071,Orleans,23,204,227,27,2355
115B,22105,Tangipahoa,12,169,181,21,3206
C20,22079,Rapides,15,373,388,46,2544
42,22073,Ouachita,595,110,705,85,2410
16B,22077,Pointe Coupee,176,186,362,43,2477
5A,22107,Tensas,3,36,39,4,3256
9-6E,22071,Orleans,0,57,57,6,2014
9-5A,22071,Orleans,0,146,146,17,2163
S28,22079,Rapides,92,14,106,12,2576
17,22055,Lafayette,40,346,386,46,1629
5-3,22099,St. Martin,458,251,709,85,2924
9-34A,22071,Orleans,3,182,185,22,2340
34A,22113,Vermilion,16,44,60,7,14555
8-21,22071,Orleans,42,244,286,34,2319
4-5,22081,Red River,5,20,25,3,2589
17,22077,Pointe Coupee,167,153,320,38,2479
22A,22077,Pointe Coupee,414,155,569,68,2481
23,22077,Pointe Coupee,164,97,261,31,2482
N18,22079,Rapides,970,158,1128,136,2541
N17,22079,Rapides,235,25,260,31,2543
17-1,22071,Orleans,42,157,199,24,2343
S10,22079,Rapides,574,63,637,77,2518
8-3,22059,La Salle,74,6,80,9,1739
1-1,22059,La Salle,119,4,123,14,1741
9-12,22071,Orleans,17,175,192,23,2330
44A,22113,Vermilion,3,0,3,0,14556
24,22101,St. Mary,21,2,23,2,2970
S21,22103,St. Tammany,99,96,195,23,3060
C4,22079,Rapides,10,501,511,61,2488
117,22105,Tangipahoa,239,107,346,41,3182
1-28,22097,St. Landry,253,169,422,51,2891
4,22101,St. Mary,85,48,133,16,2957
C02,22103,St. Tammany,192,64,256,30,3140
15-18D,22071,Orleans,69,603,672,81,2352
812,22103,St. Tammany,352,122,474,57,3052
3-1A,22099,St. Martin,4,122,126,15,2928
N12,22079,Rapides,467,118,585,70,2569
2,22093,St. James,41,49,90,10,2771
2-1,22091,St. Helena,29,434,463,56,2743
5-2,22099,St. Martin,317,63,380,45,2923
89,22017,Caddo,306,185,491,59,396
7,22101,St. Mary,158,111,269,32,2974
15B,22077,Pointe Coupee,23,21,44,5,2462
6-1,22081,Red River,7,151,158,19,2585
16,22073,Ouachita,2,316,318,38,2356
21,22077,Pointe Coupee,79,23,102,12,2468
M09,22103,St. Tammany,78,51,129,15,3137
41,22109,Terrebonne,68,57,125,15,3264
9A,22093,St. James,80,6,86,10,12957
S22,22079,Rapides,270,27,297,35,2487
C37,22079,Rapides,607,139,746,90,2490
72,22105,Tangipahoa,165,189,354,42,3161
S13,22079,Rapides,420,69,489,59,2505
C25,22079,Rapides,167,289,456,55,2515
10,22083,Richland,39,7,46,5,2621
N25,22079,Rapides,379,24,403,48,2516
1-4,22097,St. Landry,22,199,221,26,2829
5-6,22095,St. John the Baptist,43,10,53,6,2793
C01,22103,St. Tammany,275,64,339,41,3101
413,22103,St. Tammany,438,82,520,62,3057
S1,22079,Rapides,,,,,2492
34B,22083,Richland,4,7,11,1,4640
106B,22105,Tangipahoa,13,2,15,1,3242
10,22107,Tensas,57,40,97,11,3250
17,22053,Jefferson Davis,62,16,78,9,1526
5-8A,22085,Sabine,120,9,129,15,2640
105,22105,Tangipahoa,31,13,44,5,3228
3,22083,Richland,101,92,193,23,2626
C30,22079,Rapides,258,86,344,41,2510
125,22105,Tangipahoa,217,218,435,52,3210
N4,22079,Rapides,,,,,2513
412,22103,St. Tammany,421,80,501,60,2998
1,22073,Ouachita,758,80,838,101,2396
8-25,22071,Orleans,15,273,288,34,2332
1-3,22075,Plaquemines,10,260,270,32,2447
26,22031,De Soto,12,20,32,3,760
1-4A,22097,St. Landry,5,63,68,8,2884
561,22019,Calcasieu,145,20,165,19,522
12-19,22071,Orleans,5,252,257,31,2063
8-G,22051,Jefferson,59,150,209,25,1314
6-2A,22009,Avoyelles,115,20,135,16,212
411,22103,St. Tammany,592,133,725,87,3141
10-15,22057,Lafourche,153,53,206,24,1713
C27,22079,Rapides,206,113,319,38,2540
3-3,22097,St. Landry,191,70,261,31,2823
31,22073,Ouachita,199,151,350,42,2369
15-14D,22071,Orleans,12,132,144,17,2310
9-6F,22071,Orleans,2,93,95,11,2316
15-6,22071,Orleans,11,226,237,28,2322
74,22073,Ouachita,1,271,272,32,2430
79,22073,Ouachita,1,339,340,41,2362
N3,22079,Rapides,,,,,2517
31,22101,St. Mary,205,31,236,28,2963
83,22051,Jefferson,110,56,166,20,1376
149A,22105,Tangipahoa,82,18,100,12,3216
14-14,22071,Orleans,142,97,239,28,2351
3-3,22081,Red River,44,16,60,7,2594
6-2,22117,Washington,205,38,243,29,3511
409,22103,St. Tammany,216,138,354,42,3085
15-18F,22071,Orleans,117,290,407,49,2337
9-41B,22071,Orleans,99,276,375,45,2341
3,22101,St. Mary,30,227,257,31,2964
3-2,22085,Sabine,179,11,190,22,2642
S9,22079,Rapides,,,,,2557
2,22107,Tensas,38,14,52,6,3252
15,22107,Tensas,20,168,188,22,3254
27,22101,St. Mary,166,191,357,43,2955
C41,22079,Rapides,409,134,543,65,2496
2-3A,22057,Lafourche,16,38,54,6,1660
24,22055,Lafayette,35,456,491,59,1647
16-8,22071,Orleans,61,165,226,27,2144
10A,22077,Pointe Coupee,244,113,357,43,2470
12,22077,Pointe Coupee,94,70,164,19,2461
914,22103,St. Tammany,78,170,248,30,3025
3-5,22089,St. Charles,46,16,62,7,2715
59,22073,Ouachita,194,112,306,37,2409
N10,22079,Rapides,588,150,738,89,2537
4-3,22117,Washington,108,48,156,18,3528
1-2,22115,Vernon,32,226,258,31,3427
23,22073,Ouachita,0,361,361,43,2405
4-1,22081,Red River,33,79,112,13,2581
1-1,22081,Red River,167,47,214,25,2582
2-1,22085,Sabine,190,18,208,25,2643
51,22073,Ouachita,761,66,827,100,2426
72,22073,Ouachita,241,88,329,39,2428
C26,22079,Rapides,163,94,257,31,2553
38,22073,Ouachita,301,41,342,41,2414
64A,22055,Lafayette,69,12,81,9,8153
4-12,22097,St. Landry,286,38,324,39,2871
5-1,22097,St. Landry,123,39,162,19,2873
5-3,22097,St. Landry,87,380,467,56,2875
5-3,22089,St. Charles,144,158,302,36,2713
9-42,22071,Orleans,6,473,479,57,2326
11,22083,Richland,226,17,243,29,2609
74,22005,Ascension,0,94,94,11,7192
9,22077,Pointe Coupee,3,358,361,43,2460
S29,22079,Rapides,264,41,305,36,2524
43,22087,St. Bernard,111,61,172,20,2673
5-2,22081,Red River,45,203,248,30,2580
14,22093,St. James,17,420,437,52,2770
1-12,22097,St. Landry,179,104,283,34,2876
2-2,22091,St. Helena,80,91,171,20,2747
18,22073,Ouachita,5,403,408,49,2381
4-1,22095,St. John the Baptist,2,0,2,0,2780
6-3,22089,St. Charles,,,,,2724
6-1,22095,St. John the Baptist,160,294,454,54,2798
36,22073,Ouachita,201,25,226,27,2422
69,22073,Ouachita,2,350,352,42,2374
3,22073,Ouachita,156,425,581,70,2380
9-43A,22071,Orleans,8,389,397,48,2339
5-4,22097,St. Landry,73,11,84,10,2833
64B,22055,Lafayette,256,145,401,48,8154
7-1,22099,St. Martin,233,212,445,53,2914
33,22087,St. Bernard,134,67,201,24,2698
3-1,22095,St. John the Baptist,78,169,247,29,2802
19,22101,St. Mary,115,115,230,27,2983
N11,22079,Rapides,205,56,261,31,2526
6-14,22097,St. Landry,312,78,390,47,2837
53,22073,Ouachita,326,39,365,44,2389
12,22119,Webster,79,129,208,25,3568
2-2,22085,Sabine,48,5,53,6,2668
58,22087,St. Bernard,24,33,57,6,2676
1-7,22099,St. Martin,67,24,91,11,2944
7-3,22081,Red River,65,118,183,22,2590
6-13,22097,St. Landry,138,15,153,18,2855
22,22017,Caddo,486,160,646,78,389
5,22077,Pointe Coupee,63,22,85,10,2456
3-5,22097,St. Landry,330,78,408,49,2880
3-6,22099,St. Martin,45,173,218,26,2929
41,22101,St. Mary,76,71,147,17,2951
19,22073,Ouachita,4,411,415,50,2400
7-1,22081,Red River,43,31,74,8,2583
70,22073,Ouachita,2,213,215,26,2370
1-2,22085,Sabine,185,35,220,26,2633
7-2,22089,St. Charles,427,84,511,61,2740
ZZZZZZ,22095,St. John the Baptist,,,,,2787
2-1,22095,St. John the Baptist,154,192,346,41,2789
34,22087,St. Bernard,32,13,45,5,2675
55,22005,Ascension,30,235,265,32,125
2,22083,Richland,185,54,239,28,2630
8C,22093,St. James,78,36,114,13,12955
13,22093,St. James,7,414,421,50,2769
4,22093,St. James,13,17,30,3,2763
2-4A,22085,Sabine,43,6,49,5,2657
N20,22079,Rapides,623,86,709,85,2532
1-3,22099,St. Martin,45,29,74,8,2947
3-3,22089,St. Charles,290,139,429,51,2706
22,22087,St. Bernard,64,82,146,17,2674
1-2,22091,St. Helena,6,18,24,2,2752
6-11A,22097,St. Landry,50,114,164,19,2841
4,22077,Pointe Coupee,17,133,150,18,2469
1-1,22075,Plaquemines,70,121,191,23,2449
7-24,22071,Orleans,6,136,142,17,2314
8-4A,22099,St. Martin,160,59,219,26,2949
5-1,22089,St. Charles,62,488,550,66,2705
10-2,22061,Lincoln,27,4,31,3,1767
5-5,22007,Assumption,5,1,6,0,9118
4-2,22091,St. Helena,35,56,91,11,2746
3-2,22091,St. Helena,21,56,77,9,2748
51,22087,St. Bernard,5,104,109,13,2672
59,22055,Lafayette,156,108,264,31,1627
11,22093,St. James,45,137,182,22,2756
44,22073,Ouachita,439,24,463,56,2385
7-3,22089,St. Charles,527,180,707,85,2733
2-5,22089,St. Charles,675,201,876,105,2735
4-1,22091,St. Helena,229,381,610,73,2742
9-2,22059,La Salle,96,8,104,12,1731
4-2,22059,La Salle,139,8,147,17,1732
N26,22079,Rapides,660,67,727,87,2546
9-2,22099,St. Martin,153,143,296,35,2945
C2,22079,Rapides,1,208,209,25,2508
5-1,22091,St. Helena,109,382,491,59,2751
1-15,22097,St. Landry,24,206,230,27,2838
15,22093,St. James,19,133,152,18,2759
75,22005,Ascension,35,35,70,8,6887
1-5,22099,St. Martin,203,40,243,29,2900
25A,22119,Webster,0,26,26,3,7522
5-2,22095,St. John the Baptist,34,98,132,15,2809
5-4,22089,St. Charles,258,289,547,66,2741
C15,22079,Rapides,47,329,376,45,2531
6-4,22099,St. Martin,437,233,670,81,2937
26A,22063,Livingston,346,110,456,55,1788
14-23,22071,Orleans,6,188,194,23,2306
C17,22079,Rapides,123,117,240,29,2514
1-3,22059,La Salle,147,17,164,19,1733
2-8,22069,Natchitoches,25,206,231,27,1954
2-2,22099,St. Martin,445,232,677,81,2905
43,22101,St. Mary,259,32,291,35,2953
S17,22079,Rapides,49,23,72,8,2523
13-13,22071,Orleans,8,110,118,14,2317
25,22073,Ouachita,185,64,249,30,2432
30,22087,St. Bernard,153,142,295,35,2693
32,22005,Ascension,311,242,553,66,140
45,22087,St. Bernard,6,139,145,17,2677
1-6,22089,St. Charles,248,209,457,55,2731
7,22073,Ouachita,536,156,692,83,2436
11,22077,Pointe Coupee,71,65,136,16,2472
N23,22079,Rapides,412,36,448,54,2573
203,22103,St. Tammany,597,118,715,86,3024
4-2,22097,St. Landry,182,367,549,66,2878
4-9,22097,St. Landry,77,27,104,12,2868
6-3,22085,Sabine,167,61,228,27,2664
20,22087,St. Bernard,77,73,150,18,2683
73,22073,Ouachita,57,266,323,39,2411
N8,22079,Rapides,,,,,2534
25,22087,St. Bernard,82,54,136,16,2701
1-20,22097,St. Landry,67,171,238,28,2872
17,22093,St. James,121,235,356,43,2762
14,22073,Ouachita,6,480,486,58,2383
2-3,22097,St. Landry,215,70,285,34,2828
204,22103,St. Tammany,368,90,458,55,3134
24,22087,St. Bernard,157,123,280,33,2679
5-8,22097,St. Landry,128,61,189,22,2853
4-11,22097,St. Landry,23,177,200,24,2857
8-2,22071,Orleans,12,203,215,26,2328
78,22073,Ouachita,154,63,217,26,2394
15-9,22071,Orleans,5,184,189,22,2333
1-2,22015,Bossier,276,122,398,48,295
14-9,22071,Orleans,148,130,278,33,2331
1-8,22097,St. Landry,27,73,100,12,2850
44A,22073,Ouachita,591,42,633,76,2397
25,22065,Madison,30,8,38,4,1864
6-9,22097,St. Landry,136,99,235,28,2844
4-2,22089,St. Charles,375,93,468,56,2709
3-9,22099,St. Martin,0,35,35,4,2934
3-6,22089,St. Charles,,,,,2718
31,22087,St. Bernard,122,90,212,25,2682
5-1,22081,Red River,11,51,62,7,2584
3-1,22081,Red River,113,44,157,18,2595
15-5,22071,Orleans,6,146,152,18,2350
4-10,22097,St. Landry,33,76,109,13,2860
1-7,22097,St. Landry,5,255,260,31,2842
2-8,22097,St. Landry,86,27,113,13,2843
1-9,22097,St. Landry,13,308,321,38,2839
32,22073,Ouachita,646,71,717,86,2371
19A,22077,Pointe Coupee,77,121,198,23,2455
6-3,22099,St. Martin,107,12,119,14,2936
1-29,22097,St. Landry,36,618,654,79,2858
138,22017,Caddo,117,24,141,17,385
9,22093,St. James,302,98,400,48,2758
1,22077,Pointe Coupee,101,75,176,21,2466
16-3,22071,Orleans,53,155,208,25,2354
26,22073,Ouachita,81,105,186,22,2359
40A,22105,Tangipahoa,208,120,328,39,3203
6,22093,St. James,301,220,521,63,2764
16,22087,St. Bernard,49,60,109,13,2690
1-5,22095,St. John the Baptist,28,263,291,35,2786
61,22073,Ouachita,252,74,326,39,2373
7-5,22085,Sabine,120,18,138,16,2669
3-4,22099,St. Martin,111,91,202,24,2940
2-7,22097,St. Landry,52,14,66,7,2827
30,22073,Ouachita,32,152,184,22,2388
2,22005,Ascension,624,130,754,91,132
17-16,22071,Orleans,11,224,235,28,2342
9-1,22099,St. Martin,201,59,260,31,2899
4-2A,22117,Washington,206,133,339,41,3532
2-4,22015,Bossier,585,128,713,86,307
4-1,22099,St. Martin,56,26,82,9,2933
4-4,22099,St. Martin,245,52,297,35,2920
17-19,22071,Orleans,161,92,253,30,2303
7A,22093,St. James,1,104,105,12,12953
9-3,22085,Sabine,143,25,168,20,2666
12,22073,Ouachita,12,214,226,27,2392
6-4,22095,St. John the Baptist,14,290,304,36,2801
3-3,22095,St. John the Baptist,6,444,450,54,2777
5-4,22095,St. John the Baptist,258,234,492,59,2782
21,22073,Ouachita,51,260,311,37,2418
106,22103,St. Tammany,431,88,519,62,3029
6-10,22097,St. Landry,62,198,260,31,2852
1-5,22089,St. Charles,5,265,270,32,2727
C7,22079,Rapides,2,197,199,24,2498
314,22019,Calcasieu,219,144,363,43,527
1-15A,22097,St. Landry,2,172,174,21,2879
10,22073,Ouachita,22,153,175,21,2415
6-2,22099,St. Martin,134,36,170,20,2925
7-1A,22099,St. Martin,12,4,16,1,2946
N7,22079,Rapides,,,,,2559
8-4,22099,St. Martin,248,78,326,39,2939
42,22087,St. Bernard,147,83,230,27,2671
22,22101,St. Mary,86,178,264,31,2959
10-13,22071,Orleans,1,150,151,18,2301
2-12A,22015,Bossier,57,42,99,11,345
2-9,22097,St. Landry,121,58,179,21,2870
39,22101,St. Mary,109,98,207,25,2982
33,22105,Tangipahoa,99,47,146,17,3222
7A,22063,Livingston,127,17,144,17,1806
C33,22079,Rapides,237,80,317,38,2572
19A,22011,Beauregard,80,7,87,10,256
7-3,22013,Bienville,55,77,132,15,272
6-4A,22085,Sabine,34,18,52,6,2638
5,22063,Livingston,626,65,691,83,1850
5-5,22097,St. Landry,149,231,380,45,2859
40,22087,St. Bernard,42,63,105,12,2678
65,22073,Ouachita,1,73,74,8,2367
3-6A,22085,Sabine,16,6,22,2,2632
4-5,22099,St. Martin,118,42,160,19,2942
5,22093,St. James,101,143,244,29,2767
4-1,22089,St. Charles,265,178,443,53,2737
6-1,22091,St. Helena,331,114,445,53,2745
6-3,22095,St. John the Baptist,15,433,448,54,2808
4-4,22097,St. Landry,128,114,242,29,2821
46,22087,St. Bernard,83,42,125,15,2680
9-5,22059,La Salle,38,1,39,4,1734
2-1,22013,Bienville,3,241,244,29,264
C40,22079,Rapides,39,84,123,14,2547
7-4A,22099,St. Martin,6,4,10,1,2902
4-6,22097,St. Landry,28,31,59,7,2882
9,22017,Caddo,201,67,268,32,369
29,22065,Madison,25,2,27,3,1876
C1,22079,Rapides,12,74,86,10,2535
4,22055,Lafayette,642,510,1152,139,1640
10,22087,St. Bernard,74,66,140,16,2685
60,22073,Ouachita,282,246,528,63,2390
5-4,22099,St. Martin,412,111,523,63,2910
4-3,22095,St. John the Baptist,0,9,9,1,2788
4-3,22089,St. Charles,178,62,240,29,2704
C36,22079,Rapides,579,166,745,90,2549
11,22087,St. Bernard,157,144,301,36,2688
1-11,22097,St. Landry,21,212,233,28,2832
27,22073,Ouachita,44,130,174,21,2387
1C,22063,Livingston,348,21,369,44,1794
N2,22079,Rapides,,,,,2486
2-1,22081,Red River,133,30,163,19,2593
4-6,22099,St. Martin,47,13,60,7,2906
6-4B,22085,Sabine,17,4,21,2,2639
5-2,22097,St. Landry,363,64,427,51,2854
26,22063,Livingston,458,64,522,63,1798
1-3,22097,St. Landry,145,102,247,29,2851
6-5,22089,St. Charles,,,,,2732
24,22073,Ouachita,5,501,506,61,2386
1-14,22097,St. Landry,83,152,235,28,2863
308,22103,St. Tammany,292,76,368,44,3000
17,22101,St. Mary,80,104,184,22,2975
S08,22103,St. Tammany,243,123,366,44,3061
3-5,22057,Lafourche,265,167,432,52,1664
26,22041,Franklin,78,13,91,11,1081
ZZZZZZ,22089,St. Charles,,,,,2722
1-5A,22115,Vernon,38,4,42,5,3433
301,22103,St. Tammany,360,80,440,53,3128
50A,22113,Vermilion,94,35,129,15,3417
108,22105,Tangipahoa,174,129,303,36,3225
1,22109,Terrebonne,37,42,79,9,3296
2B,22119,Webster,5,0,5,0,7514
2-2,22095,St. John the Baptist,59,336,395,47,2803
817,22103,St. Tammany,463,164,627,75,3039
4,22123,West Carroll,20,21,41,4,3601
43,22105,Tangipahoa,24,122,146,17,3230
46,22109,Terrebonne,157,212,369,44,3275
25,22109,Terrebonne,290,108,398,48,3319
29,22109,Terrebonne,94,45,139,16,3332
30,22101,St. Mary,254,45,299,36,2989
21,22053,Jefferson Davis,245,84,329,39,1531
2-6,22089,St. Charles,47,33,80,9,12640
43,22051,Jefferson,208,84,292,35,1310
191,22051,Jefferson,148,418,566,68,1254
137C,22105,Tangipahoa,554,97,651,78,3165
41,22105,Tangipahoa,187,96,283,34,3157
40,22109,Terrebonne,136,139,275,33,3328
6-1,22089,St. Charles,327,189,516,62,2719
909,22103,St. Tammany,190,132,322,38,3023
C04,22103,St. Tammany,182,75,257,31,3150
907,22103,St. Tammany,56,58,114,13,3049
4-4,22089,St. Charles,73,249,322,38,2723
7-7,22127,Winn,99,16,115,13,3650
18,22105,Tangipahoa,44,200,244,29,3197
1-2,22007,Assumption,156,380,536,64,153
4-10,22095,St. John the Baptist,105,214,319,38,13275
122A,22105,Tangipahoa,383,95,478,57,3223
M01,22103,St. Tammany,369,119,488,59,3020
1-26A,22097,St. Landry,147,45,192,23,2883
104A,22105,Tangipahoa,80,52,132,15,3239
1A,22093,St. James,13,191,204,24,12644
ZZZZZZ,22103,St. Tammany,,,,,3004
901,22103,St. Tammany,187,163,350,42,3012
401,22103,St. Tammany,396,132,528,63,3092
6-1,22099,St. Martin,156,143,299,36,2919
35,22101,St. Mary,94,55,149,18,2981
415,22103,St. Tammany,208,56,264,31,3089
42,22119,Webster,137,52,189,22,3546
4012,22039,Evangeline,10,4,14,1,1044
206,22103,St. Tammany,305,58,363,43,3093
6A,22049,Jackson,,,,,4003
S06,22103,St. Tammany,228,165,393,47,3021
912,22103,St. Tammany,36,88,124,15,3080
808,22103,St. Tammany,321,107,428,51,3084
410,22103,St. Tammany,438,122,560,67,3068
1-2,22097,St. Landry,50,225,275,33,2889
1-24,22097,St. Landry,137,70,207,25,2886
312,22103,St. Tammany,342,99,441,53,3135
804,22103,St. Tammany,318,96,414,50,3072
15,22017,Caddo,125,207,332,40,487
911,22103,St. Tammany,387,89,476,57,3056
422,22103,St. Tammany,277,77,354,42,3005
915,22103,St. Tammany,317,203,520,62,3111
49,22109,Terrebonne,31,154,185,22,3321
811,22103,St. Tammany,293,163,456,55,3040
8A,22113,Vermilion,10,0,10,1,14239
7,22111,Union,211,31,242,29,3337
1,22101,St. Mary,38,5,43,5,2962
1A,22121,West Baton Rouge,504,403,907,109,5272
4,22111,Union,286,85,371,44,3364
11,22111,Union,183,122,305,36,3342
8,22111,Union,46,9,55,6,3344
2-1,22089,St. Charles,95,45,140,16,2730
162,22017,Caddo,341,90,431,52,9752
16,22105,Tangipahoa,171,65,236,28,3200
802,22103,St. Tammany,311,191,502,60,3063
102,22103,St. Tammany,581,107,688,83,3017
2-5,22009,Avoyelles,92,39,131,15,15210
7-1,22115,Vernon,209,29,238,28,3460
4-7B,22117,Washington,88,57,145,17,3506
2-2A,22115,Vernon,96,16,112,13,3446
1-5,22115,Vernon,216,51,267,32,3442
1-8A,22115,Vernon,67,52,119,14,3445
5-1,22117,Washington,152,235,387,46,3499
13,22111,Union,4,17,21,2,3340
7-1,22127,Winn,23,33,56,6,3645
127,22105,Tangipahoa,66,50,116,14,3169
226,22051,Jefferson,231,256,487,58,1377
6-7,22089,St. Charles,101,58,159,19,2725
21,22113,Vermilion,34,5,39,4,3411
905,22103,St. Tammany,214,138,352,42,3031
S15,22103,St. Tammany,150,111,261,31,3087
5-7,22095,St. John the Baptist,92,56,148,17,2784
18,22109,Terrebonne,292,129,421,50,3309
29,22101,St. Mary,192,37,229,27,2986
1-3,22089,St. Charles,188,343,531,64,2728
23,22111,Union,227,38,265,32,3347
3-4,22115,Vernon,206,25,231,27,3456
16,22111,Union,135,46,181,21,3355
17,22111,Union,193,33,226,27,3359
39,22119,Webster,234,186,420,50,3562
38,22119,Webster,76,16,92,11,3569
7-5C,22115,Vernon,52,2,54,6,3428
106A,22105,Tangipahoa,153,54,207,25,3224
1-2,22117,Washington,152,40,192,23,3500
5-3,22117,Washington,64,26,90,10,3502
6-6,22089,St. Charles,17,127,144,17,2720
S17,22103,St. Tammany,365,167,532,64,3139
1-18,22097,St. Landry,17,317,334,40,2887
120B,22105,Tangipahoa,108,59,167,20,3191
18,22113,Vermilion,552,78,630,76,3377
303,22103,St. Tammany,257,97,354,42,3070
6-3,22115,Vernon,60,8,68,8,3431
46,22073,Ouachita,342,60,402,48,2425
9,22073,Ouachita,297,277,574,69,2398
2-4,22115,Vernon,135,10,145,17,3435
7-3,22115,Vernon,68,4,72,8,3436
7-2A,22115,Vernon,261,51,312,37,3438
3-3,22117,Washington,137,48,185,22,3503
3-2,22089,St. Charles,271,190,461,55,2717
918,22103,St. Tammany,112,58,170,20,3143
MD1,22103,St. Tammany,304,91,395,47,3144
602,22103,St. Tammany,281,78,359,43,3146
F01,22103,St. Tammany,154,206,360,43,3147
3-3,22127,Winn,102,25,127,15,3660
45,22105,Tangipahoa,187,130,317,38,3238
803,22103,St. Tammany,321,161,482,58,3065
207,22103,St. Tammany,214,65,279,33,3038
101,22103,St. Tammany,273,69,342,41,3046
137,22105,Tangipahoa,339,96,435,52,3158
124,22105,Tangipahoa,223,50,273,33,3159
420,22103,St. Tammany,276,64,340,41,3022
201,22103,St. Tammany,264,175,439,53,3003
17,22109,Terrebonne,233,76,309,37,3331
10,22119,Webster,37,2,39,4,3549
57B,22113,Vermilion,58,6,64,7,3399
503,22103,St. Tammany,337,77,414,50,3129
1-3A,22097,St. Landry,172,162,334,40,2820
21,22101,St. Mary,242,55,297,35,2994
1-1,22089,St. Charles,2,305,307,37,2736
1-9,22115,Vernon,47,0,47,5,3439
72A,22105,Tangipahoa,263,157,420,50,3190
34,22101,St. Mary,191,49,240,29,2987
8,22113,Vermilion,27,0,27,3,3389
1-28A,22097,St. Landry,85,116,201,24,2896
6-5,22127,Winn,28,0,28,3,3641
5-1,22127,Winn,46,3,49,5,3647
143,22105,Tangipahoa,362,228,590,71,3232
111A,22105,Tangipahoa,38,101,139,16,3233
2-8,22015,Bossier,7,178,185,22,291
703,22103,St. Tammany,132,241,373,45,3118
705,22103,St. Tammany,145,64,209,25,3119
2-7,22015,Bossier,249,96,345,41,338
408,22103,St. Tammany,482,118,600,72,3131
11A,22121,West Baton Rouge,93,38,131,15,5283
310,22103,St. Tammany,515,120,635,76,3064
A04,22103,St. Tammany,169,59,228,27,3055
S22,22103,St. Tammany,200,132,332,40,3028
315E,22019,Calcasieu,34,325,359,43,489
S03,22103,St. Tammany,254,102,356,43,3113
3,22123,West Carroll,52,44,96,11,3607
414,22103,St. Tammany,372,75,447,54,3154
45A,22105,Tangipahoa,95,225,320,38,3208
1-29,22033,East Baton Rouge,11,387,398,48,780
701,22103,St. Tammany,188,259,447,54,3053
4-7,22117,Washington,120,16,136,16,3509
A03,22103,St. Tammany,115,62,177,21,3033
M05,22103,St. Tammany,151,121,272,32,3030
107,22103,St. Tammany,449,100,549,66,3054
813,22103,St. Tammany,147,70,217,26,3034
46A,22113,Vermilion,135,54,189,22,3409
19B,22113,Vermilion,8,7,15,1,3374
416,22103,St. Tammany,291,68,359,43,3115
9-41C,22071,Orleans,105,63,168,20,2073
C10,22103,St. Tammany,48,14,62,7,3117
815,22103,St. Tammany,107,38,145,17,3121
1-16,22097,St. Landry,90,197,287,34,2811
903,22103,St. Tammany,350,111,461,55,3083
14,22101,St. Mary,43,95,138,16,2978
18,22111,Union,180,23,203,24,3338
65,22109,Terrebonne,73,102,175,21,3334
7-1,22117,Washington,175,100,275,33,3513
89,22109,Terrebonne,393,88,481,58,3279
202,22103,St. Tammany,390,142,532,64,3086
7-1,22089,St. Charles,117,53,170,20,2726
1-21,22097,St. Landry,44,252,296,35,2824
1,22093,St. James,0,0,0,0,12643
35,22113,Vermilion,147,67,214,25,3370
403,22103,St. Tammany,303,143,446,53,3116
3,22121,West Baton Rouge,139,23,162,19,5276
418,22103,St. Tammany,334,102,436,52,3026
6-10,22001,Acadia,120,12,132,15,49
404,22103,St. Tammany,311,71,382,46,3100
1-7B,22115,Vernon,0,0,0,0,3485
125,22051,Jefferson,190,245,435,52,1402
921,22103,St. Tammany,271,105,376,45,3112
76,22109,Terrebonne,176,64,240,29,3330
14,22109,Terrebonne,766,147,913,110,3326
M06,22103,St. Tammany,540,146,686,83,3149
407,22103,St. Tammany,391,75,466,56,3069
13,22073,Ouachita,5,291,296,35,2372
S13,22103,St. Tammany,120,50,170,20,3151
S09,22103,St. Tammany,219,73,292,35,3098
129A,22105,Tangipahoa,94,229,323,39,3162
1-26,22097,St. Landry,157,29,186,22,2822
26,22101,St. Mary,72,245,317,38,2971
28,22101,St. Mary,126,93,219,26,2991
6-4,22117,Washington,172,22,194,23,3517
36,22109,Terrebonne,56,103,159,19,3273
133,22105,Tangipahoa,213,145,358,43,3180
6,22121,West Baton Rouge,0,33,33,3,5273
7,22107,Tensas,40,6,46,5,3253
125,22017,Caddo,339,294,633,76,393
3-1,22057,Lafourche,230,119,349,42,1715
74,22105,Tangipahoa,293,147,440,53,3179
120A,22105,Tangipahoa,478,89,567,68,3171
10,22101,St. Mary,11,232,243,29,2996
12A,22113,Vermilion,0,0,0,0,14241
2,22113,Vermilion,106,67,173,20,3402
12,22107,Tensas,11,173,184,22,3259
151,22105,Tangipahoa,460,81,541,65,3173
814,22103,St. Tammany,97,469,566,68,3042
11,22119,Webster,245,32,277,33,3548
4-7,22097,St. Landry,227,31,258,31,2819
42,22105,Tangipahoa,58,109,167,20,3166
8-1,22117,Washington,132,313,445,53,3526
55,22087,St. Bernard,221,252,473,57,2697
22A,22049,Jackson,4,2,6,0,4319
6-5,22095,St. John the Baptist,28,44,72,8,13279
1-8,22095,St. John the Baptist,38,42,80,9,13282
35,22073,Ouachita,308,120,428,51,2357
319S,22019,Calcasieu,42,45,87,10,3677
50,22087,St. Bernard,88,273,361,43,2686
4-8F,22015,Bossier,9,0,9,1,9765
7B,22113,Vermilion,236,40,276,33,3405
S07,22103,St. Tammany,74,166,240,29,3008
78,22109,Terrebonne,1,3,4,0,3327
55,22109,Terrebonne,273,55,328,39,3260
M07,22103,St. Tammany,329,117,446,53,3062
427,22103,St. Tammany,216,45,261,31,3125
20A-2,22113,Vermilion,39,15,54,6,3394
C08,22103,St. Tammany,97,97,194,23,3097
S11,22103,St. Tammany,192,93,285,34,3122
2B,22121,West Baton Rouge,72,21,93,11,5277
309,22103,St. Tammany,187,72,259,31,3114
3-6,22057,Lafourche,354,152,506,61,1689
8-6,22071,Orleans,6,168,174,21,2116
20,22005,Ascension,291,93,384,46,98
328,22019,Calcasieu,144,378,522,63,593
119,22105,Tangipahoa,157,127,284,34,3205
3-5,22099,St. Martin,10,11,21,2,2932
1-3,22127,Winn,75,25,100,12,3649
1-1,22115,Vernon,167,70,237,28,3490
28,22119,Webster,348,91,439,53,3570
23,22101,St. Mary,67,36,103,12,2990
51,22109,Terrebonne,319,157,476,57,3281
501,22103,St. Tammany,125,50,175,21,3156
706,22103,St. Tammany,392,113,505,61,3041
4-1A,22117,Washington,55,172,227,27,3522
12,22113,Vermilion,63,117,180,21,3376
69,22109,Terrebonne,515,128,643,77,3276
129,22105,Tangipahoa,24,129,153,18,3172
73,22105,Tangipahoa,236,95,331,40,3237
68,22109,Terrebonne,208,116,324,39,3292
1-3D,22115,Vernon,6,3,9,1,3453
7-1,22125,West Feliciana,54,40,94,11,16816
104,22105,Tangipahoa,249,55,304,36,3175
102,22105,Tangipahoa,243,132,375,45,3176
S04,22103,St. Tammany,215,77,292,35,3127
42A,22105,Tangipahoa,90,86,176,21,3187
3,22051,Jefferson,291,113,404,48,1350
4-2,22081,Red River,40,53,93,11,2592
5B,22113,Vermilion,56,7,63,7,3415
20B-2,22113,Vermilion,35,3,38,4,14246
46B-1,22113,Vermilion,110,85,195,23,3379
21,22109,Terrebonne,138,63,201,24,3280
20B-1,22113,Vermilion,108,20,128,15,3384
10-12,22071,Orleans,0,184,184,22,2012
15,22121,West Baton Rouge,4,376,380,45,5282
38,22109,Terrebonne,200,127,327,39,3298
5-2,22127,Winn,103,46,149,18,3639
7-2A,22127,Winn,42,3,45,5,3640
15-18,22071,Orleans,55,123,178,21,2299
151,22017,Caddo,67,19,86,10,422
4-9,22095,St. John the Baptist,105,225,330,39,2795
1-6,22115,Vernon,59,91,150,18,3476
2-2,22097,St. Landry,211,44,255,30,2835
81,22109,Terrebonne,6,2,8,0,3300
702,22019,Calcasieu,138,49,187,22,573
66,22109,Terrebonne,69,54,123,14,3274
6-1,22125,West Feliciana,22,9,31,3,3621
2-2,22125,West Feliciana,298,51,349,42,3624
5-1,22125,West Feliciana,26,34,60,7,3627
4-3,22125,West Feliciana,87,61,148,17,3628
4-2,22125,West Feliciana,65,18,83,10,3630
112,22105,Tangipahoa,293,70,363,43,3183
53,22109,Terrebonne,94,148,242,29,3265
6,22113,Vermilion,164,20,184,22,3375
5-1A,22001,Acadia,111,30,141,17,4
12,22109,Terrebonne,354,79,433,52,3294
10A,22113,Vermilion,197,53,250,30,3422
13A,22121,West Baton Rouge,27,246,273,33,5281
10A,22121,West Baton Rouge,130,33,163,19,5280
8-2,22115,Vernon,168,31,199,24,3495
87,22109,Terrebonne,248,109,357,43,3304
7-2,22117,Washington,350,59,409,49,3498
3-1,22117,Washington,176,47,223,26,3515
S4,22079,Rapides,,,,,2554
44,22087,St. Bernard,21,362,383,46,2670
88,22109,Terrebonne,416,114,530,64,3308
1-107,22033,East Baton Rouge,138,147,285,34,850
4-3C,22115,Vernon,6,3,9,1,3459
121A,22105,Tangipahoa,280,128,408,49,3240
14,22111,Union,8,146,154,18,3361
1-1,22125,West Feliciana,142,84,226,27,16509
34,22119,Webster,33,127,160,19,3545
6,22119,Webster,65,242,307,37,3552
28,22083,Richland,21,3,24,2,2601
6,22111,Union,244,31,275,33,3354
910,22103,St. Tammany,462,141,603,72,3104
1-23,22033,East Baton Rouge,6,347,353,42,777
46B-2,22113,Vermilion,27,40,67,8,3416
4-3F,22115,Vernon,4,0,4,0,3475
9-1,22059,La Salle,190,7,197,23,1730
1-7,22095,St. John the Baptist,7,7,14,1,13274
15,22111,Union,66,36,102,12,3339
5-5,22029,Concordia,183,9,192,23,716
42,22055,Lafayette,207,105,312,37,1642
7-2,22057,Lafourche,142,48,190,22,1693
5-5,22085,Sabine,106,10,116,14,2660
68,22055,Lafayette,66,163,229,27,1553
19,22063,Livingston,278,82,360,43,1799
36,22119,Webster,80,15,95,11,3559
12,22123,West Carroll,77,15,92,11,3614
43,22109,Terrebonne,293,122,415,50,3288
10-1,22059,La Salle,49,137,186,22,1720
67,22109,Terrebonne,50,258,308,37,3320
313,22103,St. Tammany,272,83,355,42,3081
9,22107,Tensas,23,26,49,5,3245
4-6,22117,Washington,135,57,192,23,3519
1-61,22033,East Baton Rouge,10,552,562,68,933
1,22123,West Carroll,67,65,132,15,3613
504,22103,St. Tammany,282,61,343,41,3059
801,22103,St. Tammany,450,109,559,67,3071
604,22103,St. Tammany,248,55,303,36,3073
13,22119,Webster,75,16,91,11,3572
6,22105,Tangipahoa,6,193,199,24,3198
4-1,22117,Washington,28,200,228,27,3521
N21,22079,Rapides,138,18,156,18,2548
C13,22079,Rapides,155,325,480,58,2550
S14,22079,Rapides,92,24,116,14,2551
1-1,22117,Washington,394,72,466,56,3536
4-5B,22117,Washington,68,42,110,13,3520
44,22113,Vermilion,173,29,202,24,3419
48,22105,Tangipahoa,32,87,119,14,3202
30,22017,Caddo,41,682,723,87,484
2-4,22089,St. Charles,177,287,464,56,2716
4-3N,22115,Vernon,0,0,0,0,3430
1-1,22021,Caldwell,38,54,92,11,623
10-14,22057,Lafourche,172,107,279,33,1677
57A,22113,Vermilion,194,50,244,29,3418
4-3J,22115,Vernon,36,5,41,4,3471
47,22109,Terrebonne,70,31,101,12,3270
8,22119,Webster,170,16,186,22,3544
21,22121,West Baton Rouge,173,71,244,29,4965
34,22109,Terrebonne,38,603,641,77,3297
4-8,22117,Washington,146,41,187,22,3516
4-5,22069,Natchitoches,66,10,76,9,1953
S19,22103,St. Tammany,38,115,153,18,3096
17,22105,Tangipahoa,33,263,296,35,3236
3-3A,22117,Washington,20,8,28,3,3497
56,22109,Terrebonne,100,33,133,16,3329
505,22103,St. Tammany,427,107,534,64,3088
810,22103,St. Tammany,222,87,309,37,3090
2-2,22115,Vernon,30,9,39,4,3486
A01,22103,St. Tammany,184,104,288,34,3019
44,22105,Tangipahoa,360,135,495,59,3207
14-12,22071,Orleans,77,135,212,25,2154
4-10,22117,Washington,67,328,395,47,3518
8,22121,West Baton Rouge,111,423,534,64,5278
14,22121,West Baton Rouge,21,194,215,26,5279
103,22103,St. Tammany,401,80,481,58,3045
1-1,22013,Bienville,35,84,119,14,263
9-1,22117,Washington,255,175,430,52,3507
50,22017,Caddo,9,452,461,55,426
27,22109,Terrebonne,106,36,142,17,3269
73,22051,Jefferson,316,158,474,57,1430
46,22105,Tangipahoa,6,385,391,47,3170
3-1,22115,Vernon,114,16,130,15,3464
4,22119,Webster,2,163,165,19,3560
913,22103,St. Tammany,214,315,529,64,3130
9-28,22071,Orleans,2,173,175,21,2335
N28,22079,Rapides,253,45,298,36,2495
19,22121,West Baton Rouge,140,157,297,35,4963
1-4,22095,St. John the Baptist,29,261,290,35,2785
S18,22103,St. Tammany,195,66,261,31,3078
S10,22103,St. Tammany,280,139,419,50,3095
4,22107,Tensas,2,59,61,7,3244
6-3,22125,West Feliciana,47,15,62,7,16814
5-3,22125,West Feliciana,15,87,102,12,16815
3-4,22015,Bossier,155,242,397,48,310
1-6,22001,Acadia,16,267,283,34,36
7-5,22025,Catahoula,3,38,41,4,650
28A,22105,Tangipahoa,23,33,56,6,3195
902,22103,St. Tammany,73,93,166,20,3077
40,22105,Tangipahoa,72,48,120,14,3193
101,22105,Tangipahoa,134,132,266,32,3199
27,22105,Tangipahoa,65,65,130,15,3185
402,22103,St. Tammany,343,81,424,51,3074
5041,22039,Evangeline,124,18,142,17,1043
2-3,22045,Iberia,166,171,337,40,1145
S16,22079,Rapides,338,58,396,47,2497
7-2,22115,Vernon,160,11,171,20,3447
5,22107,Tensas,4,57,61,7,3251
4-21,22071,Orleans,136,84,220,26,2346
22,22121,West Baton Rouge,230,256,486,58,4964
41,22113,Vermilion,40,3,43,5,3398
1,22119,Webster,202,32,234,28,3539
304,22103,St. Tammany,311,229,540,65,3079
1-7A,22115,Vernon,0,0,0,0,3458
149,22105,Tangipahoa,614,129,743,89,3209
S24,22103,St. Tammany,24,131,155,18,3066
82,22109,Terrebonne,86,26,112,13,3290
860N,22019,Calcasieu,286,75,361,43,553
4-9,22117,Washington,105,33,138,16,3510
1-8,22115,Vernon,58,27,85,10,3479
37,22113,Vermilion,43,270,313,37,3397
2-21B,22015,Bossier,427,112,539,65,298
9,22123,West Carroll,92,11,103,12,3616
662,22019,Calcasieu,140,65,205,24,558
1-8C,22115,Vernon,3,2,5,0,3489
16,22113,Vermilion,71,9,80,9,3371
36,22063,Livingston,415,49,464,56,1840
14,22113,Vermilion,226,56,282,34,3401
11,22109,Terrebonne,326,108,434,52,3284
110,22105,Tangipahoa,312,87,399,48,3214
8,22101,St. Mary,103,81,184,22,2973
4-3B,22117,Washington,23,14,37,4,3537
606,22103,St. Tammany,268,82,350,42,3094
13,22051,Jefferson,418,143,561,67,1255
28,22111,Union,226,43,269,32,3362
35,22109,Terrebonne,78,54,132,15,3336
1-1,22127,Winn,7,149,156,18,3634
71,22109,Terrebonne,41,148,189,22,3266
24,22077,Pointe Coupee,103,130,233,28,2465
7-1A,22117,Washington,35,266,301,36,3505
32,22119,Webster,116,96,212,25,3543
13,22109,Terrebonne,95,51,146,17,3313
84,22109,Terrebonne,153,42,195,23,3268
704,22103,St. Tammany,270,114,384,46,3148
17,22107,Tensas,71,40,111,13,3258
1-5,22097,St. Landry,98,102,200,24,2826
11,22101,St. Mary,121,50,171,20,2958
64,22109,Terrebonne,114,40,154,18,3291
2-11,22057,Lafourche,78,225,303,36,1681
6-2,22125,West Feliciana,154,124,278,33,3622
5,22123,West Carroll,150,22,172,20,3609
8-2,22025,Catahoula,1,110,111,13,660
3-3,22069,Natchitoches,41,12,53,6,1957
5-5,22045,Iberia,156,39,195,23,1167
7,22017,Caddo,57,226,283,34,354
127A,22105,Tangipahoa,100,61,161,19,3184
40,22119,Webster,94,44,138,16,3556
5-2A,22115,Vernon,0,0,0,0,3449
6-1,22115,Vernon,46,6,52,6,3450
129,22051,Jefferson,175,130,305,36,1340
9-6D,22071,Orleans,0,104,104,12,2133
3,22005,Ascension,451,124,575,69,99
33,22109,Terrebonne,31,30,61,7,3278
16,22101,St. Mary,189,88,277,33,2966
16,22123,West Carroll,210,49,259,31,3615
77,22073,Ouachita,389,108,497,60,2378
38,22017,Caddo,10,415,425,51,395
7,22119,Webster,102,14,116,14,3577
33,22101,St. Mary,159,19,178,21,2956
2-4,22097,St. Landry,429,516,945,114,2881
137D,22105,Tangipahoa,353,52,405,49,3241
40,22113,Vermilion,338,66,404,48,3407
4,22109,Terrebonne,347,152,499,60,3272
14,22119,Webster,84,38,122,14,3571
15,22119,Webster,96,40,136,16,3574
9,22119,Webster,244,61,305,36,3578
9,22109,Terrebonne,109,44,153,18,3287
23,22109,Terrebonne,74,283,357,43,3323
2,22101,St. Mary,56,138,194,23,2993
702,22103,St. Tammany,206,194,400,48,3035
46,22101,St. Mary,1,118,119,14,2995
4-3,22115,Vernon,34,5,39,4,3457
25,22119,Webster,3,329,332,40,3563
4-1,22115,Vernon,135,25,160,19,3488
116,22105,Tangipahoa,231,109,340,41,3181
15-18B,22071,Orleans,35,285,320,38,2266
22,22119,Webster,75,43,118,14,3557
5-1A,22115,Vernon,31,0,31,3,3440
38,22113,Vermilion,14,165,179,21,3388
28,22105,Tangipahoa,102,43,145,17,3221
20A-1,22113,Vermilion,44,12,56,6,3413
8-3,22117,Washington,266,51,317,38,3535
1-23,22097,St. Landry,202,289,491,59,2866
5A-1,22113,Vermilion,6,0,6,0,14237
10-1,22045,Iberia,67,253,320,38,9112
10A,22049,Jackson,62,4,66,7,4005
45A-1,22113,Vermilion,11,4,15,1,14557
11A,22107,Tensas,13,22,35,4,4646
4011,22039,Evangeline,35,8,43,5,1045
1-52,22033,East Baton Rouge,437,251,688,83,791
1-10,22069,Natchitoches,,,,,1977
9-44O,22071,Orleans,7,255,262,31,2274
8-2B,22009,Avoyelles,111,13,124,15,169
7A,22121,West Baton Rouge,230,48,278,33,5274
2-18F,22015,Bossier,165,23,188,22,10081
2-18C,22015,Bossier,311,66,377,45,10083
9-43F,22071,Orleans,5,213,218,26,2315
7-20,22071,Orleans,0,338,338,40,2238
1-3C,22115,Vernon,11,1,12,1,3441
53,22113,Vermilion,58,12,70,8,3372
55,22113,Vermilion,80,12,92,11,3366
58,22109,Terrebonne,92,68,160,19,3322
4-3,22071,Orleans,1,89,90,10,2320
1-8,22033,East Baton Rouge,170,158,328,39,826
1-5,22033,East Baton Rouge,19,451,470,56,842
87,22051,Jefferson,218,115,333,40,1403
49,22055,Lafayette,371,174,545,65,1573
57,22073,Ouachita,784,73,857,103,2435
54,22113,Vermilion,43,60,103,12,3393
9-43I,22071,Orleans,10,199,209,25,2247
14B,22047,Iberville,33,25,58,7,1192
N15,22079,Rapides,212,34,246,29,2564
14-25,22071,Orleans,32,164,196,23,2056
2-5,22043,Grant,179,17,196,23,10400
1-84,22033,East Baton Rouge,19,846,865,104,793
40A,22063,Livingston,432,41,473,57,1822
4-3,22057,Lafourche,122,58,180,21,1661
700,22019,Calcasieu,100,44,144,17,588
2-10,22057,Lafourche,85,61,146,17,1703
99,22109,Terrebonne,21,9,30,3,13606
108,22055,Lafayette,644,68,712,86,1599
308,22019,Calcasieu,5,287,292,35,601
4001,22039,Evangeline,138,9,147,17,1030
C22,22079,Rapides,93,27,120,14,2570
6,22123,West Carroll,186,11,197,23,3608
4-2,22043,Grant,177,15,192,23,10718
39-1,22067,Morehouse,107,36,143,17,3680
2,22119,Webster,258,77,335,40,3538
3-12,22033,East Baton Rouge,352,310,662,80,949
C24,22079,Rapides,88,263,351,42,2539
5-K,22051,Jefferson,544,93,637,77,1354
6-6,22071,Orleans,9,291,300,36,2018
93,22055,Lafayette,220,86,306,37,1571
49,22105,Tangipahoa,95,144,239,28,3188
97,22051,Jefferson,165,86,251,30,1349
37,22031,De Soto,146,106,252,30,734
4040,22039,Evangeline,45,3,48,5,1057
7-15,22071,Orleans,4,211,215,26,2026
8,22109,Terrebonne,353,126,479,57,3277
83,22017,Caddo,185,398,583,70,481
2-12,22057,Lafourche,382,103,485,58,1654
10-14,22071,Orleans,1,159,160,19,2152
7-5,22115,Vernon,249,22,271,32,3461
15,22073,Ouachita,2,313,315,38,2433
7-4,22115,Vernon,20,4,24,2,3480
6-4,22115,Vernon,179,8,187,22,3481
3-5,22115,Vernon,174,9,183,22,3483
5-5,22127,Winn,72,6,78,9,3655
1-2A,22115,Vernon,2,0,2,0,3454
10-1,22057,Lafourche,142,107,249,30,1708
10-11,22057,Lafourche,63,52,115,13,1718
23,22113,Vermilion,254,54,308,37,3396
19,22111,Union,132,29,161,19,3349
7-2,22085,Sabine,117,29,146,17,2654
5-1,22115,Vernon,387,49,436,52,3429
2,22111,Union,98,41,139,16,3346
36A-1,22113,Vermilion,40,40,80,9,3381
3-2,22115,Vernon,67,9,76,9,3466
17,22073,Ouachita,19,260,279,33,2417
10,22111,Union,65,41,106,12,3363
816,22103,St. Tammany,177,77,254,30,3132
3051,22039,Evangeline,30,6,36,4,1017
16-1,22071,Orleans,29,157,186,22,2053
7-28A,22071,Orleans,5,273,278,33,2276
101,22055,Lafayette,613,97,710,85,1602
310,22019,Calcasieu,128,136,264,31,567
7-19,22071,Orleans,6,262,268,32,2043
12-16,22071,Orleans,1,178,179,21,2265
24,22119,Webster,0,165,165,19,3553
5,22053,Jefferson Davis,63,207,270,32,1522
8-3,22115,Vernon,156,21,177,21,3468
1-3,22115,Vernon,291,157,448,54,3469
3-8,22071,Orleans,7,237,244,29,2192
72,22109,Terrebonne,279,109,388,46,3324
1-3B,22115,Vernon,2,0,2,0,3455
179B,22051,Jefferson,11,211,222,26,1341
26-K,22051,Jefferson,20,222,242,29,1355
S02,22103,St. Tammany,180,67,247,29,3136
3-3,22099,St. Martin,83,244,327,39,2938
16,22053,Jefferson Davis,101,108,209,25,1534
8-7,22059,La Salle,135,4,139,16,1728
106,22055,Lafayette,534,136,670,81,1558
5-2,22117,Washington,146,27,173,20,3504
26,22119,Webster,136,171,307,37,3558
67,22055,Lafayette,370,89,459,55,1613
85,22055,Lafayette,,,,,1610
21-K,22051,Jefferson,19,233,252,30,1492
5-1,22043,Grant,219,23,242,29,10717
8-1,22085,Sabine,125,22,147,17,2649
3-1,22071,Orleans,132,220,352,42,2136
3-42,22033,East Baton Rouge,58,120,178,21,836
468,22019,Calcasieu,278,58,336,40,602
10-4,22045,Iberia,225,77,302,36,1115
1-9,22069,Natchitoches,131,37,168,20,1975
4-3G,22115,Vernon,39,37,76,9,3452
9-4,22045,Iberia,365,45,410,49,1170
1-7,22061,Lincoln,0,0,0,0,15863
21,22055,Lafayette,41,240,281,34,1635
3-10,22069,Natchitoches,,,,,1945
6-8,22097,St. Landry,227,87,314,37,2813
15-2,22071,Orleans,67,263,330,39,2323
3-6,22097,St. Landry,179,198,377,45,2840
73,22109,Terrebonne,194,78,272,32,3333
70,22017,Caddo,47,627,674,81,372
29,22111,Union,299,36,335,40,3365
309W,22019,Calcasieu,9,304,313,37,552
36,22101,St. Mary,104,135,239,28,2977
1-3,22013,Bienville,42,25,67,8,276
3-3,22043,Grant,17,51,68,8,1109
4-3K,22115,Vernon,38,6,44,5,3472
2-G,22051,Jefferson,91,133,224,27,1308
100,22051,Jefferson,115,61,176,21,1467
5-4,22029,Concordia,133,69,202,24,699
4-8,22069,Natchitoches,80,17,97,11,1939
3-1,22043,Grant,16,140,156,18,1100
4-5,22127,Winn,160,13,173,20,3635
15-14,22071,Orleans,70,229,299,36,2222
8-27,22071,Orleans,5,188,193,23,2059
6-16A,22097,St. Landry,76,169,245,29,2874
30,22047,Iberville,198,211,409,49,1203
1-1B,22115,Vernon,6,10,16,1,3443
3-1,22127,Winn,20,3,23,2,3658
9-44N,22071,Orleans,4,328,332,40,1996
192,22051,Jefferson,347,259,606,73,1280
3A,22093,St. James,41,12,53,6,12647
S15,22079,Rapides,254,117,371,44,2493
807,22103,St. Tammany,302,82,384,46,3106
46B-3,22113,Vermilion,61,23,84,10,3390
1161,22039,Evangeline,33,4,37,4,1021
3-3,22033,East Baton Rouge,,,,,787
N27,22079,Rapides,598,72,670,81,2501
4-23,22071,Orleans,149,108,257,31,2232
27A,22011,Beauregard,132,19,151,18,239
4-2,22115,Vernon,71,6,77,9,3448
165,22019,Calcasieu,318,124,442,53,600
336,22019,Calcasieu,397,132,529,64,519
9-31B,22071,Orleans,2,184,186,22,2020
30,22041,Franklin,358,57,415,50,1065
171,22051,Jefferson,8,32,40,4,1294
4-1,22127,Winn,49,7,56,6,3643
107,22109,Terrebonne,0,2,2,0,13918
8A,22063,Livingston,291,45,336,40,1847
5A,22113,Vermilion,40,5,45,5,3387
29,22063,Livingston,321,85,406,49,1830
23,22047,Iberville,6,114,120,14,1175
18,22101,St. Mary,10,197,207,25,2961
7-27,22071,Orleans,0,170,170,20,2028
4-8E,22015,Bossier,194,33,227,27,10084
2-18D,22015,Bossier,138,61,199,24,10086
6-9,22071,Orleans,57,244,301,36,2353
12,22041,Franklin,178,40,218,26,1080
14-16,22071,Orleans,125,205,330,39,2147
N5,22079,Rapides,,,,,2485
12-12,22071,Orleans,14,160,174,21,2096
5-2,22125,West Feliciana,97,182,279,33,3632
2-1,22071,Orleans,83,168,251,30,2203
9-1,22007,Assumption,407,160,567,68,164
13B,22047,Iberville,5,101,106,12,1208
13,22101,St. Mary,104,80,184,22,2952
8-1,22115,Vernon,166,14,180,21,3474
32,22083,Richland,164,91,255,30,2612
11-G,22051,Jefferson,139,298,437,52,1347
37,22051,Jefferson,228,96,324,39,1248
3-2,22095,St. John the Baptist,22,184,206,24,2799
6-1A,22127,Winn,28,26,54,6,3642
35,22027,Claiborne,11,8,19,2,675
37,22101,St. Mary,192,34,226,27,2969
1-50,22033,East Baton Rouge,15,420,435,52,849
27B,22011,Beauregard,99,35,134,16,245
13-5,22071,Orleans,36,218,254,30,2288
15,22113,Vermilion,169,79,248,30,3378
27A-2,22113,Vermilion,18,1,19,2,3385
1-5,22127,Winn,10,109,119,14,3671
1-2A,22097,St. Landry,60,239,299,36,2869
8-2,22061,Lincoln,509,65,574,69,1760
16A,22077,Pointe Coupee,11,10,21,2,2475
10,22123,West Carroll,119,43,162,19,3610
3,22111,Union,50,189,239,28,3350
3-30,22033,East Baton Rouge,719,168,887,107,908
1-8E,22115,Vernon,1,0,1,0,3451
8,22123,West Carroll,103,24,127,15,3605
110,22109,Terrebonne,87,57,144,17,13921
2-23,22015,Bossier,37,25,62,7,300
2,22065,Madison,57,15,72,8,1872
3-14,22033,East Baton Rouge,757,164,921,111,938
11A,22063,Livingston,270,63,333,40,1841
20,22101,St. Mary,3,240,243,29,2980
6-3,22117,Washington,217,34,251,30,3524
466W,22019,Calcasieu,481,68,549,66,508
332N,22019,Calcasieu,108,75,183,22,506
760,22019,Calcasieu,212,56,268,32,512
118,22109,Terrebonne,0,0,0,0,13923
95,22109,Terrebonne,13,3,16,1,13602
2-3,22099,St. Martin,4,133,137,16,2904
1-4B,22115,Vernon,22,22,44,5,3487
1-K,22051,Jefferson,492,139,631,76,1326
35,22031,De Soto,168,46,214,25,758
5-1,22057,Lafourche,108,33,141,17,1695
3-3,22045,Iberia,153,46,199,24,1119
4-5,22117,Washington,119,75,194,23,3525
83,22109,Terrebonne,412,115,527,63,3295
14,22123,West Carroll,55,14,69,8,3603
2,22105,Tangipahoa,74,443,517,62,3192
16-6,22071,Orleans,27,259,286,34,2221
18,22123,West Carroll,88,8,96,11,3611
9,22111,Union,19,23,42,5,3356
20,22111,Union,193,12,205,24,3357
12-6,22061,Lincoln,4,21,25,3,11357
9-43K,22071,Orleans,7,237,244,29,2237
370,22019,Calcasieu,312,230,542,65,507
761,22019,Calcasieu,169,25,194,23,583
65,22055,Lafayette,56,76,132,15,1543
4-11,22117,Washington,62,98,160,19,3527
3-5,22033,East Baton Rouge,,,,,886
116,22109,Terrebonne,23,6,29,3,14233
36A-2,22113,Vermilion,17,15,32,3,14235
42A-1,22113,Vermilion,0,0,0,0,14236
3-1B,22009,Avoyelles,111,51,162,19,204
5-16,22071,Orleans,58,103,161,19,2122
17,22063,Livingston,353,99,452,54,1832
114,22017,Caddo,46,247,293,35,9755
320W,22019,Calcasieu,45,190,235,28,3674
319N,22019,Calcasieu,40,64,104,12,3675
7-2B,22099,St. Martin,19,2,21,2,13596
1-15,22033,East Baton Rouge,3,623,626,75,950
6-7,22071,Orleans,5,155,160,19,2092
10,22053,Jefferson Davis,339,52,391,47,1535
15,22123,West Carroll,26,7,33,3,3606
5B,22093,St. James,6,63,69,8,12646
27,22063,Livingston,289,306,595,71,1844
8B,22113,Vermilion,114,8,122,14,14240
916,22103,St. Tammany,77,47,124,15,3099
70A,22105,Tangipahoa,85,75,160,19,3231
1-4C,22115,Vernon,2,1,3,0,3462
11A,22049,Jackson,45,12,57,6,4006
26-2,22067,Morehouse,80,74,154,18,3685
26,22083,Richland,78,17,95,11,2617
39B,22063,Livingston,148,18,166,20,8155
3-7,22069,Natchitoches,8,34,42,5,1982
6-H,22051,Jefferson,105,46,151,18,1408
337,22019,Calcasieu,270,98,368,44,536
28,22051,Jefferson,140,60,200,24,1353
9-37,22071,Orleans,5,255,260,31,2250
10-7,22071,Orleans,22,98,120,14,2260
9-35A,22071,Orleans,2,117,119,14,2327
62,22073,Ouachita,128,172,300,36,2401
3-3,22115,Vernon,47,3,50,6,3470
4-2,22025,Catahoula,143,20,163,19,648
5030,22039,Evangeline,98,8,106,12,1042
5-8,22071,Orleans,0,114,114,13,2281
4-13,22095,St. John the Baptist,5,13,18,2,13286
2-2,22127,Winn,13,5,18,2,3653
8-K,22051,Jefferson,311,204,515,62,1297
C42,22079,Rapides,465,136,601,72,2509
45A,22113,Vermilion,130,23,153,18,3406
5-8,22085,Sabine,77,38,115,13,2648
C23,22079,Rapides,287,28,315,38,2556
26A,22065,Madison,0,0,0,0,4322
2-4E,22115,Vernon,40,20,60,7,3467
5-4,22071,Orleans,0,49,49,5,2148
323,22019,Calcasieu,48,205,253,30,493
27-1,22067,Morehouse,222,34,256,30,3678
805,22103,St. Tammany,343,92,435,52,3091
5A,22093,St. James,8,58,66,7,12645
15A,22093,St. James,18,76,94,11,12958
25A,22049,Jackson,46,23,69,8,4321
51,22113,Vermilion,201,60,261,31,3373
1-6,22097,St. Landry,110,24,134,16,2865
33,22073,Ouachita,635,92,727,87,2395
6-15,22097,St. Landry,31,302,333,40,2816
3-1C,22099,St. Martin,10,9,19,2,13593
5,22027,Claiborne,101,103,204,24,672
39,22005,Ascension,60,114,174,21,142
31,22051,Jefferson,263,87,350,42,1267
4-1B,22099,St. Martin,11,26,37,4,13594
25B,22049,Jackson,14,9,23,2,4320
3-8,22069,Natchitoches,135,73,208,25,1988
13-9,22071,Orleans,89,153,242,29,2193
5-3,22071,Orleans,38,133,171,20,2196
11-1,22057,Lafourche,61,63,124,15,1675
5-8,22095,St. John the Baptist,80,13,93,11,13273
16A,22093,St. James,43,43,86,10,12962
321,22019,Calcasieu,53,258,311,37,532
46B-4,22113,Vermilion,113,52,165,19,14558
N13B,22079,Rapides,363,84,447,54,12635
1-8F,22115,Vernon,0,0,0,0,3477
3-1B,22127,Winn,38,61,99,11,3665
3031,22039,Evangeline,88,38,126,15,1052
139,22105,Tangipahoa,123,55,178,21,3164
5-2,22029,Concordia,25,18,43,5,701
21-2,22067,Morehouse,35,61,96,11,3683
4-2,22069,Natchitoches,0,142,142,17,1944
113,22017,Caddo,318,157,475,57,9763
1-1,22095,St. John the Baptist,37,19,56,6,2792
160W,22019,Calcasieu,193,33,226,27,533
M03,22103,St. Tammany,186,54,240,29,3153
121,22105,Tangipahoa,120,19,139,16,3215
9-17,22071,Orleans,4,201,205,24,2269
61,22109,Terrebonne,63,54,117,14,3289
1,22105,Tangipahoa,35,13,48,5,3217
7-5,22095,St. John the Baptist,54,40,94,11,2781
13,22087,St. Bernard,131,137,268,32,2694
8-4B,22099,St. Martin,153,51,204,24,13597
5-5,22089,St. Charles,224,169,393,47,2734
5-2,22071,Orleans,41,84,125,15,2126
C07,22103,St. Tammany,33,70,103,12,3107
6-6,22095,St. John the Baptist,11,123,134,16,13281
4-14,22095,St. John the Baptist,0,9,9,1,13284
2-4,22001,Acadia,222,8,230,27,34
6-2,22081,Red River,15,134,149,18,2587
6-2A,22085,Sabine,72,15,87,10,2667
22,22111,Union,274,37,311,37,3352
1-9,22095,St. John the Baptist,6,14,20,2,13283
S01,22103,St. Tammany,380,116,496,60,3007
806,22103,St. Tammany,330,165,495,59,3075
54,22109,Terrebonne,45,41,86,10,3316
4-G,22051,Jefferson,32,131,163,19,1352
3-1,22089,St. Charles,732,203,935,113,2712
39-2,22067,Morehouse,24,162,186,22,3687
20B,22049,Jackson,0,6,6,0,4318
3-6,22095,St. John the Baptist,7,1,8,0,13272
N13A,22079,Rapides,215,46,261,31,12636
4-5,22089,St. Charles,28,33,61,7,12642
105,22109,Terrebonne,0,2,2,0,13916
12-1,22045,Iberia,10,215,225,27,1116
5-3,22127,Winn,105,19,124,15,3662
4-2,22071,Orleans,31,145,176,21,2082
3-1C,22127,Winn,4,3,7,0,3663
16,22119,Webster,328,98,426,51,3541
26,22111,Union,93,126,219,26,3348
6,22049,Jackson,167,24,191,23,1219
17-15,22071,Orleans,2,250,252,30,2035
1091,22039,Evangeline,69,82,151,18,1010
110,22055,Lafayette,425,64,489,59,1578
38,22101,St. Mary,128,37,165,19,2972
1-1,22097,St. Landry,14,219,233,28,2885
261,22019,Calcasieu,117,40,157,18,499
63,22073,Ouachita,133,153,286,34,2393
5A,22111,Union,5,10,15,1,7838
320E,22019,Calcasieu,25,192,217,26,3676
1-6A,22115,Vernon,5,9,14,1,3484
19BI,22049,Jackson,0,1,1,0,4316
31,22109,Terrebonne,71,231,302,36,3325
14,22077,Pointe Coupee,17,151,168,20,2458
49B-1,22113,Vermilion,515,67,582,70,3421
2-3,22015,Bossier,108,47,155,18,346
95,22055,Lafayette,,,,,1584
6-1,22097,St. Landry,140,130,270,32,2846
4,22083,Richland,335,99,434,52,2625
17,22083,Richland,205,76,281,34,2598
5-4,22127,Winn,129,8,137,16,3652
6-1,22127,Winn,98,28,126,15,3656
211,22051,Jefferson,123,82,205,24,1302
8-2,22043,Grant,225,21,246,29,1108
15-8,22071,Orleans,3,168,171,20,2284
164,22017,Caddo,57,10,67,8,9756
7-7,22095,St. John the Baptist,75,137,212,25,13285
8-1,22009,Avoyelles,59,15,74,8,166
405,22103,St. Tammany,275,89,364,44,3006
4-2A,22127,Winn,10,2,12,1,3654
2-7,22089,St. Charles,,,,,12639
1-2,22099,St. Martin,38,27,65,7,2941
123,22105,Tangipahoa,220,165,385,46,3218
142,22017,Caddo,248,26,274,33,413
2-3A,22015,Bossier,94,152,246,29,10075
4A,22111,Union,2,5,7,0,7837
4-12,22095,St. John the Baptist,13,16,29,3,13278
4-11,22095,St. John the Baptist,24,320,344,41,13280
4,22051,Jefferson,234,99,333,40,1331
19AI,22049,Jackson,6,26,32,3,4315
19BII,22049,Jackson,3,16,19,2,4317
4-6,22015,Bossier,561,215,776,93,330
48,22109,Terrebonne,61,176,237,28,3310
7-1A,22127,Winn,70,13,83,10,3666
34,22051,Jefferson,267,86,353,42,1463
24,22067,Morehouse,8,3,11,1,1922
11,22123,West Carroll,13,41,54,6,3600
3-2,22117,Washington,73,376,449,54,3512
17,22087,St. Bernard,31,32,63,7,12963
17-5,22071,Orleans,16,197,213,25,2104
25A,22113,Vermilion,93,10,103,12,14552
904,22103,St. Tammany,200,228,428,51,3047
3-2,22127,Winn,129,15,144,17,3669
7-5,22127,Winn,64,19,83,10,3664
11-2,22071,Orleans,13,233,246,29,2302
8-1,22045,Iberia,267,59,326,39,1154
1-4A,22115,Vernon,13,2,15,1,3473
165,22017,Caddo,141,83,224,27,9754
N14B,22079,Rapides,75,19,94,11,12638
8B,22093,St. James,127,45,172,20,12952
19C,22049,Jackson,2,0,2,0,4313
10,22049,Jackson,189,19,208,25,1234
104,22055,Lafayette,,,,,1595
7C,22063,Livingston,103,15,118,14,8159
1-7A,22099,St. Martin,34,29,63,7,13592
9-4,22071,Orleans,7,165,172,20,2214
1,22113,Vermilion,,,,,3414
7-4A,22115,Vernon,48,13,61,7,3424
15,22101,St. Mary,71,102,173,20,2985
1,22107,Tensas,160,121,281,34,3246
11,22107,Tensas,122,25,147,17,3247
9-2,22057,Lafourche,129,64,193,23,1712
2-5,22069,Natchitoches,108,35,143,17,1962
4-4,22069,Natchitoches,117,110,227,27,1971
13-6,22071,Orleans,47,140,187,22,2109
4-6,22069,Natchitoches,80,23,103,12,1964
1-3B,22015,Bossier,107,43,150,18,9766
4-3A,22115,Vernon,102,18,120,14,3426
31,22119,Webster,186,44,230,27,3551
90,22051,Jefferson,231,90,321,38,1275
9-6B,22071,Orleans,0,63,63,7,2117
1-59,22033,East Baton Rouge,2,243,245,29,861
70,22105,Tangipahoa,381,127,508,61,3227
4-3M,22115,Vernon,2,0,2,0,3432
17,22011,Beauregard,173,16,189,22,242
2-6,22095,St. John the Baptist,14,47,61,7,12965
2-5,22095,St. John the Baptist,7,3,10,1,12966
2-3,22069,Natchitoches,113,15,128,15,1965
35,22087,St. Bernard,14,18,32,3,12964
7-4,22095,St. John the Baptist,170,102,272,32,13287
11,22113,Vermilion,154,42,196,23,3420
32B,22113,Vermilion,9,82,91,11,3368
4021,22039,Evangeline,9,0,9,1,1003
18,22035,East Carroll,42,17,59,7,979
4-9A,22117,Washington,167,55,222,26,3523
5-2,22057,Lafourche,261,76,337,40,1671
42A,22113,Vermilion,219,69,288,34,3380
21-1,22067,Morehouse,51,35,86,10,3682
63,22109,Terrebonne,75,46,121,14,13925
2-2,22043,Grant,129,16,145,17,1097
N14A,22079,Rapides,98,31,129,15,12637
118,22105,Tangipahoa,575,191,766,92,3196
27,22083,Richland,210,37,247,29,2605
28,22113,Vermilion,266,48,314,37,3423
4,22073,Ouachita,336,222,558,67,2364
S6B,22079,Rapides,,,,,12633
52,22109,Terrebonne,117,98,215,26,3262
52,22087,St. Bernard,175,230,405,49,2699
49B-3,22113,Vermilion,32,12,44,5,3410
1,22111,Union,385,60,445,53,3351
4-1,22125,West Feliciana,107,56,163,19,3625
1-17,22097,St. Landry,546,199,745,90,2836
26-1,22067,Morehouse,178,52,230,27,3679
2-22B,22015,Bossier,292,22,314,37,324
S27,22079,Rapides,176,23,199,24,2529
7-4,22125,West Feliciana,0,15,15,1,3623
9-26,22071,Orleans,1,124,125,15,2130
3-2,22067,Morehouse,4,6,10,1,3684
S05,22103,St. Tammany,377,153,530,64,3050
27,22119,Webster,38,196,234,28,3554
7-11,22071,Orleans,4,195,199,24,2177
65A,22073,Ouachita,1,143,144,17,4633
11-5,22045,Iberia,25,27,52,6,1130
76,22017,Caddo,356,132,488,59,9762
111,22055,Lafayette,777,110,887,107,1568
1-4,22045,Iberia,59,25,84,10,8800
16B,22093,St. James,27,46,73,8,12961
29,22113,Vermilion,201,44,245,29,3404
1-4D,22115,Vernon,0,0,0,0,3425
17,22017,Caddo,113,245,358,43,360
112,22109,Terrebonne,9,7,16,1,13924
7-8,22095,St. John the Baptist,143,119,262,31,13276
S18,22079,Rapides,52,129,181,21,2491
10-K,22051,Jefferson,203,98,301,36,1474
3-5,22069,Natchitoches,136,22,158,19,1976
160,22017,Caddo,235,56,291,35,9758
109,22109,Terrebonne,8,1,9,1,13920
9-1,22061,Lincoln,39,335,374,45,1782
45,22073,Ouachita,650,48,698,84,2399
2-15,22033,East Baton Rouge,100,155,255,30,834
7-3,22021,Caldwell,69,11,80,9,624
23A,22101,St. Mary,75,18,93,11,8166
10,22109,Terrebonne,326,169,495,59,3311
6-9,22089,St. Charles,55,18,73,8,12641
2-H,22051,Jefferson,229,60,289,34,1323
1A,22063,Livingston,173,12,185,22,1848
7-28,22071,Orleans,7,202,209,25,2084
44,22101,St. Mary,15,125,140,16,2967
7,22123,West Carroll,60,4,64,7,3604
4-3,22127,Winn,169,63,232,28,3661
3-1,22067,Morehouse,191,172,363,43,3681
194A,22051,Jefferson,211,153,364,44,1434
2-32,22033,East Baton Rouge,409,493,902,109,797
182,22051,Jefferson,91,112,203,24,1480
198,22051,Jefferson,280,213,493,59,1293
12-4,22045,Iberia,114,54,168,20,1114
115,22017,Caddo,690,128,818,98,9764
47,22101,St. Mary,100,78,178,21,2992
114,22105,Tangipahoa,286,51,337,40,3226
2-3,22127,Winn,28,177,205,24,3651
917,22103,St. Tammany,115,54,169,20,3155
103,22109,Terrebonne,76,75,151,18,13914
47,22055,Lafayette,293,106,399,48,1628
15-13,22071,Orleans,18,238,256,30,2101
14,22011,Beauregard,171,29,200,24,235
1-6,22043,Grant,9,2,11,1,10403
12,22101,St. Mary,136,201,337,40,2979
62,22109,Terrebonne,60,31,91,11,3302
1090,22039,Evangeline,24,54,78,9,1046
17-4,22071,Orleans,13,150,163,19,2189
6-2,22089,St. Charles,405,166,571,69,2739
3-35,22033,East Baton Rouge,446,227,673,81,903
4-2A,22099,St. Martin,52,13,65,7,13595
20,22109,Terrebonne,162,176,338,40,3271
C34,22079,Rapides,177,57,234,28,2533
1,22031,De Soto,12,101,113,13,764
2-1,22007,Assumption,191,43,234,28,157
1-4,22069,Natchitoches,24,200,224,27,1947
7C,22037,East Feliciana,,,,,14585
1-4,22061,Lincoln,0,0,0,0,12314
11-8,22045,Iberia,154,36,190,22,8804
11-6,22045,Iberia,104,54,158,19,8807
6,22037,East Feliciana,168,97,265,32,14582
35,22083,Richland,42,119,161,19,2618
16,22109,Terrebonne,317,80,397,48,16508
3-2,22097,St. Landry,141,71,212,25,8486
56,22113,Vermilion,213,30,243,29,3369
133,22017,Caddo,216,109,325,39,414
3-3C,22117,Washington,123,28,151,18,3530
334,22019,Calcasieu,272,77,349,42,513
1-4,22015,Bossier,390,163,553,66,317
2-1,22069,Natchitoches,56,15,71,8,1972
9A,22037,East Feliciana,,,,,14591
31,22063,Livingston,81,25,106,12,1791
124,22051,Jefferson,520,175,695,84,1321
1-5A,22001,Acadia,140,43,183,22,31
1-4A,22069,Natchitoches,2,8,10,1,1968
3-1,22059,La Salle,179,14,193,23,1723
9-4,22009,Avoyelles,282,57,339,41,15202
14-15,22071,Orleans,113,107,220,26,2166
176,22051,Jefferson,82,51,133,16,1424
12-3,22071,Orleans,15,244,259,31,2324
1-5,22061,Lincoln,0,0,0,0,12313
7-4,22099,St. Martin,121,254,375,45,2931
M02,22103,St. Tammany,303,161,464,56,3120
9-5B,22009,Avoyelles,30,222,252,30,15201
361,22019,Calcasieu,33,267,300,36,571
8-2,22059,La Salle,52,8,60,7,1740
85,22109,Terrebonne,396,58,454,54,3314
117,22051,Jefferson,286,148,434,52,1393
1-21,22033,East Baton Rouge,3,223,226,27,798
1B,22121,West Baton Rouge,150,83,233,28,5592
19,22109,Terrebonne,287,120,407,49,3318
6-11B,22097,St. Landry,38,54,92,11,8481
M10,22103,St. Tammany,452,103,555,67,3043
106,22109,Terrebonne,0,0,0,0,13917
9-36,22071,Orleans,2,250,252,30,2312
52,22017,Caddo,13,396,409,49,482
6-5,22045,Iberia,231,54,285,34,8806
9-1A,22009,Avoyelles,58,76,134,16,180
1-32,22033,East Baton Rouge,6,529,535,64,939
2-11,22015,Bossier,41,47,88,10,332
234,22051,Jefferson,320,301,621,75,1451
C39,22079,Rapides,28,58,86,10,2528
17B,22037,East Feliciana,8,22,30,3,14584
9,22055,Lafayette,299,223,522,63,1547
10-3A,22009,Avoyelles,170,43,213,25,14889
8-3,22045,Iberia,361,86,447,54,8805
4,22121,West Baton Rouge,118,33,151,18,4967
2-2,22003,Allen,202,40,242,29,72
6-2,22009,Avoyelles,0,0,0,0,15213
1160,22039,Evangeline,9,208,217,26,1047
9-2A,22009,Avoyelles,78,70,148,17,14892
12A,22083,Richland,10,7,17,2,4634
15A,22077,Pointe Coupee,199,144,343,41,2473
3-1,22091,St. Helena,120,311,431,52,2753
S5,22079,Rapides,,,,,2511
5,22119,Webster,84,28,112,13,3567
161,22017,Caddo,143,30,173,20,9757
1-4,22127,Winn,27,4,31,3,3657
7-23,22071,Orleans,5,454,459,55,2204
12B,22037,East Feliciana,5,3,8,0,14588
6-1,22043,Grant,219,27,246,29,1101
13A,22049,Jackson,56,3,59,7,4007
11-2,22061,Lincoln,55,8,63,7,1764
368,22019,Calcasieu,658,166,824,99,509
60,22031,De Soto,30,108,138,16,767
60,22109,Terrebonne,181,136,317,38,3293
70,22051,Jefferson,309,214,523,63,1332
12A,22037,East Feliciana,33,165,198,23,14580
C03,22103,St. Tammany,210,95,305,36,3010
19B,22037,East Feliciana,80,69,149,18,14583
2-3,22057,Lafourche,158,96,254,30,1687
12-2,22045,Iberia,21,183,204,24,1149
47,22105,Tangipahoa,34,234,268,32,3234
163,22017,Caddo,195,136,331,40,9753
3-37,22033,East Baton Rouge,322,80,402,48,940
3-1,22061,Lincoln,103,151,254,30,1746
9-4B,22009,Avoyelles,125,38,163,19,15204
5-2,22089,St. Charles,59,23,82,9,2729
1-1,22057,Lafourche,346,134,480,58,1663
31,22083,Richland,94,58,152,18,2614
24,22063,Livingston,771,87,858,103,1797
22-K,22051,Jefferson,6,278,284,34,1385
3-2A,22097,St. Landry,138,86,224,27,8485
2-16A,22015,Bossier,4,10,14,1,315
57B-1,22113,Vermilion,46,9,55,6,14560
7-35,22071,Orleans,12,367,379,45,2292
4-3,22099,St. Martin,356,168,524,63,2922
1-25,22097,St. Landry,8,197,205,24,2849
15,22105,Tangipahoa,113,81,194,23,3211
25,22005,Ascension,330,87,417,50,107
157,22017,Caddo,133,56,189,22,459
7-3,22007,Assumption,78,11,89,10,9119
7A,22113,Vermilion,52,1,53,6,3403
1-3,22085,Sabine,140,39,179,21,2662
9-44M,22071,Orleans,15,301,316,38,2162
12-5,22045,Iberia,54,88,142,17,9114
7B,22037,East Feliciana,,,,,14581
4-1,22043,Grant,216,22,238,28,1093
14-21,22071,Orleans,80,166,246,29,2229
10-13,22057,Lafourche,171,77,248,30,1652
19A,22049,Jackson,0,3,3,0,1238
11-4,22057,Lafourche,131,32,163,19,1662
63,22055,Lafayette,42,163,205,24,1600
2-1,22075,Plaquemines,418,174,592,71,2439
2010A,22039,Evangeline,33,1,34,4,8793
10,22093,St. James,78,111,189,22,2761
108,22017,Caddo,235,64,299,36,449
13,22049,Jackson,84,112,196,23,1241
1-6B,22115,Vernon,8,8,16,1,3434
9,22113,Vermilion,201,65,266,32,3383
2-2,22045,Iberia,1,77,78,9,1137
9-2,22085,Sabine,109,24,133,16,2653
12,22083,Richland,345,40,385,46,2616
3-3,22013,Bienville,51,63,114,13,274
14,22065,Madison,66,16,82,9,1867
7-4,22057,Lafourche,86,305,391,47,1669
217,22051,Jefferson,273,527,800,96,1380
S19,22079,Rapides,89,23,112,13,2536
4-6,22061,Lincoln,73,7,80,9,11992
2-1,22009,Avoyelles,242,128,370,44,15207
6-3,22045,Iberia,299,74,373,45,8803
2-12,22033,East Baton Rouge,157,651,808,97,879
8,22037,East Feliciana,80,56,136,16,14577
603,22103,St. Tammany,291,72,363,43,3036
8-3,22009,Avoyelles,104,10,114,13,14893
1-12,22033,East Baton Rouge,385,191,576,69,916
31,22027,Claiborne,151,88,239,28,677
4-2,22095,St. John the Baptist,0,7,7,0,2779
5,22017,Caddo,44,920,964,116,477
11-2A,22009,Avoyelles,89,25,114,13,184
85,22027,Claiborne,19,86,105,12,669
70,22005,Ascension,34,10,44,5,6883
2A,22063,Livingston,421,54,475,57,1792
2-1B,22125,West Feliciana,66,25,91,11,7207
5,22109,Terrebonne,146,270,416,50,3301
37,22073,Ouachita,325,60,385,46,2361
15,22109,Terrebonne,374,75,449,54,3261
10-4,22061,Lincoln,53,25,78,9,1766
91,22055,Lafayette,576,115,691,83,1556
105,22017,Caddo,226,119,345,41,438
10-1,22061,Lincoln,14,117,131,15,1755
3-15,22071,Orleans,17,133,150,18,2257
137A,22105,Tangipahoa,336,82,418,50,3168
20,22121,West Baton Rouge,137,64,201,24,4962
2-6,22069,Natchitoches,100,30,130,15,1973
3-4,22095,St. John the Baptist,54,445,499,60,2778
6-2,22043,Grant,149,20,169,20,1095
21A,22063,Livingston,182,22,204,24,15869
2-2,22009,Avoyelles,1,4,5,0,14882
12-6,22045,Iberia,65,130,195,23,9113
2-1,22059,La Salle,232,32,264,31,1737
1-54,22033,East Baton Rouge,252,684,936,113,941
8,22027,Claiborne,47,144,191,23,694
14-20,22071,Orleans,136,257,393,47,2029
4-4,22071,Orleans,6,97,103,12,2321
2-5E,22009,Avoyelles,1,0,1,0,15212
2,22123,West Carroll,199,63,262,31,3602
601,22103,St. Tammany,205,55,260,31,3011
12-5,22061,Lincoln,0,0,0,0,12316
172,22051,Jefferson,141,224,365,44,1405
8-3,22043,Grant,78,5,83,10,1105
N1,22079,Rapides,,,,,2527
34A,22083,Richland,1,26,27,3,4639
6-2,22085,Sabine,216,28,244,29,2659
7-2,22127,Winn,104,4,108,13,3636
62,22017,Caddo,119,450,569,68,444
5020,22039,Evangeline,66,30,96,11,1015
5,22111,Union,137,31,168,20,3341
16,22051,Jefferson,148,71,219,26,1483
21,22063,Livingston,466,92,558,67,1827
44,22031,De Soto,47,163,210,25,753
12-4,22061,Lincoln,0,1,1,0,12318
134,22017,Caddo,102,66,168,20,390
2-2D,22009,Avoyelles,3,8,11,1,14883
2-4,22043,Grant,4,1,5,0,15227
7D,22037,East Feliciana,,,,,14586
N16,22079,Rapides,155,24,179,21,2561
13,22083,Richland,86,336,422,51,2610
4-3,22043,Grant,117,10,127,15,14881
1-3,22043,Grant,162,15,177,21,1104
133A,22105,Tangipahoa,138,73,211,25,3235
9-36B,22071,Orleans,4,313,317,38,2169
4-2,22099,St. Martin,52,23,75,9,2916
17A,22093,St. James,21,29,50,6,12960
1-4,22115,Vernon,23,15,38,4,3437
1-3,22009,Avoyelles,137,18,155,18,14885
3-3,22009,Avoyelles,40,75,115,13,15206
426,22103,St. Tammany,191,44,235,28,3058
34,22083,Richland,310,125,435,52,2607
4-5,22057,Lafourche,282,133,415,50,1683
2-29,22033,East Baton Rouge,670,499,1169,141,827
2-3,22001,Acadia,194,63,257,31,14
8-1,22043,Grant,12,4,16,1,10402
18,22037,East Feliciana,63,9,72,8,14571
11-7,22045,Iberia,48,13,61,7,8802
3-2,22021,Caldwell,113,34,147,17,625
809,22103,St. Tammany,96,174,270,32,3145
1,22065,Madison,77,29,106,12,1865
43,22055,Lafayette,258,86,344,41,1549
5A,22119,Webster,2,15,17,2,7515
1-6,22061,Lincoln,0,0,0,0,11677
21A,22113,Vermilion,110,16,126,15,14247
262,22019,Calcasieu,140,19,159,19,561
7-5,22013,Bienville,44,20,64,7,9435
39,22063,Livingston,323,65,388,46,1834
3-13,22033,East Baton Rouge,889,374,1263,152,945
25,22083,Richland,132,23,155,18,2611
19A-1,22113,Vermilion,13,2,15,1,14242
2-5,22007,Assumption,35,14,49,5,9121
5-2,22091,St. Helena,19,2,21,2,2754
4-17,22071,Orleans,207,153,360,43,2311
18,22121,West Baton Rouge,140,76,216,26,4966
2-1,22127,Winn,13,64,77,9,3644
13-2,22045,Iberia,292,77,369,44,1123
112,22017,Caddo,208,87,295,35,9761
4-3B,22015,Bossier,110,26,136,16,10079
3-7B,22085,Sabine,12,0,12,1,12323
41A,22101,St. Mary,116,43,159,19,8167
1-104,22033,East Baton Rouge,74,462,536,64,944
1,22083,Richland,162,31,193,23,2629
20,22065,Madison,0,123,123,14,1881
8-1,22025,Catahoula,77,143,220,26,653
4-10A,22117,Washington,6,169,175,21,3533
17-K,22051,Jefferson,311,169,480,58,1502
23A,22063,Livingston,240,90,330,39,1823
28,22109,Terrebonne,45,18,63,7,3283
9-3,22061,Lincoln,9,6,15,1,12317
17,22121,West Baton Rouge,37,67,104,12,5285
3-6,22061,Lincoln,33,2,35,4,11042
42A,22087,St. Bernard,177,93,270,32,16494
7A-1,22113,Vermilion,40,2,42,5,14238
1-1,22007,Assumption,19,250,269,32,9116
2-5,22013,Bienville,9,14,23,2,9434
7B,22121,West Baton Rouge,67,43,110,13,5593
39,22055,Lafayette,201,127,328,39,1649
4-3,22097,St. Landry,293,197,490,59,2892
6-8,22089,St. Charles,46,49,95,11,2707
2C,22107,Tensas,6,9,15,1,4641
2-4,22013,Bienville,4,9,13,1,9125
7-3,22043,Grant,320,17,337,40,10715
6-4,22043,Grant,54,10,64,7,10721
12-3,22061,Lincoln,0,0,0,0,12315
27,22041,Franklin,88,57,145,17,1072
5A,22101,St. Mary,87,162,249,30,8163
38,22031,De Soto,68,113,181,21,742
1-5,22043,Grant,0,0,0,0,10399
8A,22077,Pointe Coupee,7,185,192,23,7844
7-7,22043,Grant,14,1,15,1,10401
17,22119,Webster,225,51,276,33,3540
14-4,22045,Iberia,224,54,278,33,1136
8-1A,22085,Sabine,1,4,5,0,12324
362,22019,Calcasieu,379,87,466,56,526
17A,22119,Webster,30,58,88,10,7518
8-1,22099,St. Martin,214,83,297,35,2948
7-2A,22125,West Feliciana,28,183,211,25,7205
2-1A,22125,West Feliciana,134,68,202,24,7206
12,22121,West Baton Rouge,27,35,62,7,5284
5-3,22043,Grant,118,12,130,15,10406
17A,22111,Union,58,6,64,7,7842
5,22121,West Baton Rouge,127,21,148,17,5275
1-75,22033,East Baton Rouge,454,226,680,82,804
6,22035,East Carroll,6,182,188,22,974
2-3,22013,Bienville,0,0,0,0,9127
18,22119,Webster,83,520,603,72,3576
29,22119,Webster,270,49,319,38,3575
312,22019,Calcasieu,40,523,563,68,534
4-4,22117,Washington,97,36,133,16,3534
12,22067,Morehouse,10,200,210,25,1932
16,22121,West Baton Rouge,195,179,374,45,5287
111,22017,Caddo,7,288,295,35,9760
1,22037,East Feliciana,268,54,322,38,14574
10-16,22057,Lafourche,104,88,192,23,1699
2-5,22097,St. Landry,117,41,158,19,2817
25,22101,St. Mary,113,67,180,21,8474
20A,22077,Pointe Coupee,441,167,608,73,2463
2-4,22007,Assumption,85,30,115,13,9123
C11B,22079,Rapides,1,125,126,15,12325
3B,22063,Livingston,149,24,173,20,8157
2,22037,East Feliciana,66,52,118,14,14575
3-1A,22127,Winn,38,38,76,9,3646
3-18,22033,East Baton Rouge,402,424,826,99,844
2,22023,Cameron,7,6,13,1,637
10-2A,22009,Avoyelles,273,32,305,36,14886
25B,22011,Beauregard,57,42,99,11,219
21,22037,East Feliciana,107,120,227,27,14564
13,22037,East Feliciana,37,208,245,29,14565
16-7,22071,Orleans,42,177,219,26,2030
12-1,22061,Lincoln,187,184,371,44,1747
4,22037,East Feliciana,249,89,338,40,14573
16,22037,East Feliciana,124,330,454,54,14568
71,22105,Tangipahoa,241,209,450,54,3220
43,22119,Webster,198,156,354,42,3565
9,22121,West Baton Rouge,42,52,94,11,5286
7-2B,22125,West Feliciana,9,10,19,2,7204
3-5,22071,Orleans,0,47,47,5,2200
14,22037,East Feliciana,62,93,155,18,14566
19A,22037,East Feliciana,261,114,375,45,14569
11A,22037,East Feliciana,109,228,337,40,14567
441,22019,Calcasieu,222,153,375,45,539
101,22017,Caddo,269,132,401,48,400
18,22055,Lafayette,10,471,481,58,1540
237,22051,Jefferson,246,412,658,79,1311
3-7,22013,Bienville,0,6,6,0,9124
1-4,22013,Bienville,29,9,38,4,9432
25,22051,Jefferson,549,187,736,89,1410
9-16,22071,Orleans,13,160,173,20,2061
7-7,22071,Orleans,3,200,203,24,2156
20,22053,Jefferson Davis,107,53,160,19,1529
4-3,22007,Assumption,42,70,112,13,9122
3-6,22013,Bienville,9,7,16,1,9126
13B,22121,West Baton Rouge,1,55,56,6,5595
1-2,22061,Lincoln,46,100,146,17,1748
7-25,22071,Orleans,5,294,299,36,2244
7-8,22071,Orleans,2,233,235,28,2186
6-1A,22097,St. Landry,204,48,252,30,8480
10,22037,East Feliciana,54,67,121,14,14578
3-6,22085,Sabine,100,18,118,14,2658
88,22017,Caddo,314,251,565,68,430
6-5B,22097,St. Landry,17,21,38,4,8792
C21,22079,Rapides,157,563,720,87,2578
13-1,22045,Iberia,221,36,257,31,1144
2-3,22043,Grant,109,19,128,15,1096
20A-3,22113,Vermilion,18,14,32,3,14244
1-4,22043,Grant,11,2,13,1,10398
3-4,22043,Grant,8,2,10,1,10407
60,22051,Jefferson,502,198,700,84,1270
45,22101,St. Mary,127,48,175,21,2965
40,22067,Morehouse,158,22,180,21,1897
2-2,22007,Assumption,31,12,43,5,151
11-4,22061,Lincoln,12,1,13,1,11044
33,22119,Webster,224,86,310,37,3547
C11A,22079,Rapides,11,46,57,6,12326
111,22109,Terrebonne,32,59,91,11,13922
166,22017,Caddo,196,69,265,32,9759
10B,22121,West Baton Rouge,30,101,131,15,5594
6-5A,22097,St. Landry,0,24,24,2,8487
115,22109,Terrebonne,0,29,29,3,14232
11A,22065,Madison,3,30,33,3,4325
8A,22065,Madison,15,7,22,2,4326
2-6,22013,Bienville,5,5,10,1,9433
5-3,22021,Caldwell,135,39,174,21,620
6-3,22007,Assumption,13,147,160,19,9117
5-2,22045,Iberia,64,86,150,18,1120
11-1,22061,Lincoln,37,240,277,33,1775
860S,22019,Calcasieu,273,172,445,53,528
24C,22063,Livingston,627,115,742,89,1851
N24,22079,Rapides,714,76,790,95,2571
7-4,22013,Bienville,112,160,272,32,281
3-1,22021,Caldwell,40,5,45,5,618
17A,22037,East Feliciana,268,267,535,64,14570
2,22073,Ouachita,320,80,400,48,2391
20,22017,Caddo,267,131,398,48,462
13-7,22071,Orleans,51,119,170,20,2224
17-3,22071,Orleans,12,219,231,27,2231
3-14,22071,Orleans,17,119,136,16,2295
15-12,22071,Orleans,15,112,127,15,2267
14-K,22051,Jefferson,285,270,555,67,1453
2-2A,22097,St. Landry,41,57,98,11,8482
6-5,22097,St. Landry,28,25,53,6,2893
2-5A,22015,Bossier,36,50,86,10,9767
8B,22077,Pointe Coupee,0,59,59,7,7843
17,22049,Jackson,30,14,44,5,1231
2-2B,22009,Avoyelles,39,136,175,21,168
6-3A,22097,St. Landry,51,71,122,14,8479
5-6,22097,St. Landry,93,37,130,15,2814
20B,22077,Pointe Coupee,81,65,146,17,2483
1-6,22095,St. John the Baptist,2,26,28,3,12967
19B,22077,Pointe Coupee,16,4,20,2,7847
19A,22065,Madison,0,36,36,4,4324
2-21D,22015,Bossier,656,157,813,98,340
307,22019,Calcasieu,2,178,180,21,523
4-3D,22015,Bossier,305,113,418,50,10078
2-18E,22015,Bossier,569,142,711,86,10082
26A,22113,Vermilion,142,36,178,21,14553
3-4,22097,St. Landry,179,97,276,33,2862
C38A,22079,Rapides,39,80,119,14,12632
9-1,22057,Lafourche,110,118,228,27,1678
4-2,22007,Assumption,67,341,408,49,154
15-17B,22071,Orleans,89,149,238,28,2060
10,22035,East Carroll,1,104,105,12,978
5A,22049,Jackson,,,,,1233
2-5A,22097,St. Landry,134,42,176,21,8484
3A,22123,West Carroll,47,9,56,6,7512
N22,22079,Rapides,198,18,216,26,2522
5-1A,22009,Avoyelles,25,12,37,4,14884
C38B,22079,Rapides,281,139,420,50,12327
2-22C,22015,Bossier,247,19,266,32,10080
7-2,22007,Assumption,116,19,135,16,160
15A,22065,Madison,0,17,17,2,4323
24A,22101,St. Mary,250,70,320,38,8475
45,22055,Lafayette,286,86,372,45,1562
5-3,22061,Lincoln,304,47,351,42,1786
8-4,22043,Grant,249,20,269,32,10713
10-3,22061,Lincoln,5,6,11,1,11672
2-21C,22015,Bossier,654,81,735,88,305
6-3,22127,Winn,134,14,148,17,3670
317,22019,Calcasieu,121,184,305,36,529
15,22037,East Feliciana,109,70,179,21,14561
20,22037,East Feliciana,99,288,387,46,14562
11-2,22045,Iberia,100,32,132,15,1148
19,22053,Jefferson Davis,346,166,512,61,1527
3010,22039,Evangeline,204,47,251,30,1008
42B,22113,Vermilion,21,3,24,2,3367
M04,22103,St. Tammany,216,116,332,40,3018
25A,22101,St. Mary,150,82,232,28,8473
10-6,22061,Lincoln,1,188,189,22,11352
1-6A,22097,St. Landry,68,11,79,9,8478
19A,22063,Livingston,128,22,150,18,8161
19B-1,22113,Vermilion,31,25,56,6,14243
2B,22107,Tensas,13,5,18,2,4642
2-5,22001,Acadia,242,27,269,32,25
5-5,22001,Acadia,91,23,114,13,11
7-1,22007,Assumption,213,191,404,48,152
10-2,22009,Avoyelles,179,237,416,50,14887
5,22005,Ascension,348,136,484,58,112
4,22023,Cameron,217,50,267,32,15223
12,22023,Cameron,38,32,70,8,15225
367,22019,Calcasieu,249,72,321,38,15221
303,22019,Calcasieu,2,202,204,24,15222
9B,22037,East Feliciana,,,,,14579
2-1,22029,Concordia,75,354,429,51,15538
8-3,22075,Plaquemines,38,50,88,10,16179
7-1,22075,Plaquemines,39,106,145,17,16182
6-2,22075,Plaquemines,149,96,245,29,16184
6-1,22075,Plaquemines,14,62,76,9,16185
8-1,22075,Plaquemines,180,167,347,41,16183
5-2,22075,Plaquemines,,,,,16186
5-1,22075,Plaquemines,294,76,370,44,16187
4-1,22075,Plaquemines,300,135,435,52,16188
906,22103,St. Tammany,152,130,282,34,3048
34,22073,Ouachita,50,46,96,11,2377
4-8,22097,St. Landry,30,59,89,10,2861
90,22109,Terrebonne,337,60,397,48,3307
3-3,22021,Caldwell,78,30,108,13,610
6-6,22127,Winn,31,7,38,4,3659
4-3A,22015,Bossier,312,192,504,60,336
10-9,22071,Orleans,71,122,193,23,2241
7,22093,St. James,1,234,235,28,2766
3-7,22085,Sabine,58,8,66,7,2646
4-K,22051,Jefferson,338,161,499,60,1457
109,22105,Tangipahoa,115,227,342,41,3186
107,22105,Tangipahoa,71,168,239,28,3204
7,22109,Terrebonne,147,398,545,65,3315
1-44,22033,East Baton Rouge,62,138,200,24,813
2-2,22089,St. Charles,110,68,178,21,2710
3-19,22071,Orleans,37,229,266,32,2235
7-9A,22071,Orleans,2,151,153,18,1995
107,22017,Caddo,134,80,214,25,452
34,22113,Vermilion,103,82,185,22,3392
609,22103,St. Tammany,15,2,17,2,16507
2-3A,22009,Avoyelles,122,26,148,17,211
1-3,22095,St. John the Baptist,19,622,641,77,2796
8,22051,Jefferson,152,75,227,27,1482
9,22101,St. Mary,52,258,310,37,2960
C11,22103,St. Tammany,93,30,123,14,3109
302,22103,St. Tammany,358,104,462,55,3067
315W,22019,Calcasieu,124,87,211,25,575
1-42,22033,East Baton Rouge,465,302,767,92,781
4-4A,22015,Bossier,508,133,641,77,293
205,22051,Jefferson,43,495,538,65,1468
8-2,22117,Washington,81,122,203,24,3514
173,22051,Jefferson,8,205,213,25,1378
85,22017,Caddo,191,382,573,69,425
408,22019,Calcasieu,311,78,389,47,606
3-11,22033,East Baton Rouge,41,127,168,20,921
195,22051,Jefferson,71,614,685,82,1274
2-10,22033,East Baton Rouge,213,430,643,77,830
1-4A,22001,Acadia,220,39,259,31,59
5-1,22029,Concordia,108,152,260,31,711
27-2,22067,Morehouse,117,5,122,14,3686
2-22A,22015,Bossier,621,103,724,87,316
N29,22079,Rapides,209,30,239,28,2538
7-2,22095,St. John the Baptist,276,221,497,60,2790
24,22111,Union,167,111,278,33,3360
55,22067,Morehouse,45,26,71,8,1911
3-3B,22117,Washington,22,132,154,18,3529
10-3,22057,Lafourche,207,118,325,39,1714
463,22019,Calcasieu,416,109,525,63,510
76,22005,Ascension,434,88,522,63,15216
166E,22019,Calcasieu,295,56,351,42,15218
35,22119,Webster,209,119,328,39,3555
41,22119,Webster,482,140,622,75,3561
6-2,22115,Vernon,63,12,75,9,3465
11,22105,Tangipahoa,52,172,224,27,3160
2-2,22057,Lafourche,588,175,763,92,1711
2-1,22115,Vernon,538,70,608,73,3463
152,22051,Jefferson,67,203,270,32,1330
24,22113,Vermilion,184,66,250,30,3382
5-17,22071,Orleans,135,151,286,34,2207
4-13,22097,St. Landry,152,12,164,19,2888
3-1,22033,East Baton Rouge,,,,,862
87,22027,Claiborne,13,145,158,19,682
4-3,22029,Concordia,7,156,163,19,15542
1,22035,East Carroll,64,58,122,14,970
6,22101,St. Mary,164,27,191,23,2984
54,22051,Jefferson,179,111,290,35,1485
12,22111,Union,56,157,213,25,3343
9-44L,22071,Orleans,3,315,318,38,2240
3,22113,Vermilion,89,20,109,13,3391
64,22073,Ouachita,217,54,271,32,2429
19A,22113,Vermilion,357,57,414,50,3412
150,22051,Jefferson,209,509,718,86,1301
1-2,22089,St. Charles,139,308,447,54,2738
1-9,22001,Acadia,273,33,306,37,24
5-2B,22029,Concordia,16,5,21,2,15535
3-4,22029,Concordia,225,38,263,31,15536
2-21,22033,East Baton Rouge,645,331,976,118,843
405,22019,Calcasieu,606,146,752,90,497
25,22063,Livingston,374,73,447,54,1813
5,22047,Iberville,128,77,205,24,1177
9-5,22099,St. Martin,219,94,313,37,2912
197A,22051,Jefferson,5,85,90,10,1458
229,22051,Jefferson,223,100,323,39,1394
3-2,22003,Allen,259,59,318,38,76
4A,22107,Tensas,15,17,32,3,3248
10,22031,De Soto,231,170,401,48,737
3-1,22009,Avoyelles,109,327,436,52,15205
2-7A,22069,Natchitoches,9,16,25,3,1979
78,22005,Ascension,334,102,436,52,15214
77,22005,Ascension,319,89,408,49,15215
3-24,22033,East Baton Rouge,57,764,821,99,785
4-20,22071,Orleans,165,91,256,30,2127
23,22051,Jefferson,87,91,178,21,1335
S23,22103,St. Tammany,117,36,153,18,3016
2-5B,22097,St. Landry,126,22,148,17,8483
28,22055,Lafayette,523,123,646,78,15854
114,22055,Lafayette,134,26,160,19,15855
25,22113,Vermilion,479,95,574,69,3386
3-2,22045,Iberia,333,111,444,53,1155
4-6,22001,Acadia,252,28,280,33,13
2-3,22081,Red River,172,19,191,23,2588
C05,22103,St. Tammany,195,58,253,30,2999
18A,22063,Livingston,8,0,8,0,8160
59,22017,Caddo,14,428,442,53,392
21,22119,Webster,215,135,350,42,3550
7-4,22043,Grant,59,3,62,7,10722
30,22055,Lafayette,317,99,416,50,15856
97,22055,Lafayette,141,46,187,22,15857
115,22055,Lafayette,352,65,417,50,15858
9-4,22099,St. Martin,185,68,253,30,2921
4-5,22001,Acadia,290,35,325,39,8
9-21,22071,Orleans,1,308,309,37,2140
32,22041,Franklin,191,59,250,30,1070
6-4,22089,St. Charles,79,67,146,17,2721
19,22041,Franklin,169,40,209,25,1071
9B,22053,Jefferson Davis,278,47,325,39,1518
50,22067,Morehouse,122,59,181,21,1910
4,22053,Jefferson Davis,184,26,210,25,15547
5-1,22059,La Salle,426,35,461,55,1736
8-5,22061,Lincoln,6,1,7,0,15860
8-3,22061,Lincoln,18,45,63,7,15861
8-26,22071,Orleans,6,244,250,30,2068
2-28,22033,East Baton Rouge,208,346,554,67,810
1-1,22003,Allen,68,32,100,12,77
S6A,22079,Rapides,,,,,12634
3-54,22033,East Baton Rouge,42,143,185,22,937
8-4,22061,Lincoln,12,6,18,2,15862
9-5,22061,Lincoln,7,5,12,1,15867
9-6,22061,Lincoln,5,5,10,1,15868
23C,22063,Livingston,376,64,440,53,16174
9-41D,22071,Orleans,54,97,151,18,2058
205,22103,St. Tammany,420,79,499,60,3027
40,22101,St. Mary,121,48,169,20,2976
20A-4,22113,Vermilion,4,9,13,1,14245
7,22035,East Carroll,1,118,119,14,961
4-1A,22021,Caldwell,20,3,23,2,3994
861E,22019,Calcasieu,152,98,250,30,540
4-2,22075,Plaquemines,,,,,16176
2-2,22075,Plaquemines,,,,,16175
9-1,22075,Plaquemines,127,103,230,27,16181
154,22051,Jefferson,3,530,533,64,1442
3-45,22033,East Baton Rouge,857,201,1058,128,927
2-6,22085,Sabine,192,28,220,26,2650
14,22055,Lafayette,100,234,334,40,1563
62,22055,Lafayette,3,101,104,12,1591
15-1,22071,Orleans,41,94,135,16,2305
3,22093,St. James,406,395,801,96,2765
4-2,22057,Lafourche,178,93,271,32,1666
C06,22103,St. Tammany,113,158,271,32,3082
429,22103,St. Tammany,206,48,254,30,16500
111,22103,St. Tammany,288,63,351,42,16502
12,22011,Beauregard,408,71,479,57,247
2-2A,22085,Sabine,69,11,80,9,2644
2-3,22089,St. Charles,286,110,396,47,2714
52,22073,Ouachita,694,107,801,96,2384
5-5,22003,Allen,101,8,109,13,67
2-2F,22009,Avoyelles,75,49,124,15,15211
24B,22063,Livingston,282,33,315,38,1829
42,22017,Caddo,2,103,105,12,443
417,22103,St. Tammany,323,76,399,48,16501
110,22103,St. Tammany,361,100,461,55,16503
314,22103,St. Tammany,295,101,396,47,16504
5-4,22045,Iberia,259,82,341,41,1166
74,22109,Terrebonne,36,7,43,5,3286
4-8,22095,St. John the Baptist,0,0,0,0,13277
306,22103,St. Tammany,273,42,315,38,3123
466E,22019,Calcasieu,313,51,364,44,577
6-4,22097,St. Landry,266,176,442,53,2864
6-1,22061,Lincoln,373,121,494,59,1749
108,22103,St. Tammany,399,107,506,61,16505
147,22105,Tangipahoa,135,30,165,19,16506
6,22053,Jefferson Davis,199,58,257,31,1515
81,22017,Caddo,53,474,527,63,441
3030,22039,Evangeline,172,125,297,35,1024
9-28C,22071,Orleans,1,87,88,10,2338
5-3,22013,Bienville,92,5,97,11,266
260,22019,Calcasieu,289,58,347,41,562
16,22031,De Soto,512,83,595,71,726
3-2,22013,Bienville,59,161,220,26,271
26,22105,Tangipahoa,35,172,207,25,3201
